emp_total_female_45_64, total_male_15_64, employment_female, employment_female_25_44, emp_total_male_65up, employment_male_rate, employment_female_25_44_rate, employment_male_15_24, sa2_name16, employment_male, employment_female_45_64_rate, emp_total_person_15up, employment_male_65up, emp_total_female_15up, emp_total_female_25_44, emp_total_male_15up, employment_female_rate, employment_female_15_24_rate, emp_total_male_15_24, total_person_15_64, employment_male_45_64_rate, employment_male_25_44_rate, emp_total_male_25_44, employment_rate, employment_male_25_44, employment_female_65up, employment_female_45_64, employment_female_15_24, employment_male_45_64, total_female_15_64, employment_total, employment_female_65up_rate, emp_total_female_15_24, emp_total_female_65up, employment_male_65up_rate, sa2_code16, employment_male_15_24_rate, emp_total_male_45_64
574,1023,769,244,394,86.31476,72.403564,81,"Braidwood",883,67.59582,2839,128,1422,337,1417,74.299515,50.0,145,2058,73.58156,82.48408,314,80.27211,259,75,388,62,415,1035,1652,19.379845,124,387,32.48731,"101021007",55.86207,564
1103,2590,2028,840,449,83.12741,80.30593,345,"Karabar",2153,72.620125,6227,88,3188,1046,3039,76.01199,65.70328,536,5258,78.8705,88.6076,1027,79.51693,910,46,801,341,810,2668,4181,8.846154,519,520,19.59911,"101021008",64.36567,1027
502,924,737,218,363,90.47619,82.88973,78,"Cooma Region",836,72.70916,2493,127,1206,263,1287,81.25689,60.56338,141,1831,77.77778,85.92593,270,85.90934,232,68,365,86,399,907,1573,22.742476,142,299,34.986225,"101031015",55.31915,513
885,2288,1811,745,449,91.171326,89.32854,309,"Jindabyne - Berridale",2086,81.80791,5173,128,2436,834,2737,88.12652,74.10714,429,4343,83.76963,93.91593,904,89.7306,849,93,724,249,800,2055,3897,24.409449,336,381,28.507795,"101031016",72.02797,955
1002,1910,1230,437,963,68.481674,66.81957,189,"Batemans Bay",1308,56.087826,5865,87,2992,654,2873,63.43476,61.13074,314,3849,56.431534,77.21519,632,65.9392,488,58,562,173,544,1939,2538,5.5080724,283,1053,9.034268,"101041017",60.191082,964
1197,1926,1476,471,1140,71.54725,70.29851,180,"Batemans Bay - South",1378,60.56809,6511,109,3445,670,3066,67.060425,60.479042,328,4127,62.512363,77.85349,587,69.15435,457,78,725,202,632,2201,2854,6.2700963,334,1244,9.561403,"101041018",54.878048,1011
1225,2244,1720,570,779,78.43137,71.69811,240,"Bega - Tathra",1760,66.85714,6333,102,3310,795,3023,71.10376,59.14787,406,4663,71.6862,85.45953,729,74.630066,623,95,819,236,795,2419,3480,10.662177,399,891,13.09371,"101041019",59.1133,1109
1607,2540,1770,479,869,76.1811,70.131775,208,"Bega-Eden Hinterland",1935,61.48102,6774,204,3365,683,3409,66.8429,52.793297,393,5188,67.31392,80.23256,602,71.4148,483,114,988,189,1040,2648,3705,15.899582,358,717,23.47526,"101041020",52.92621,1545
478,805,628,206,417,75.2795,81.42293,76,"Broulee - Tomakin",606,65.89958,2566,31,1344,253,1222,72.76941,64.393936,136,1668,66.42686,88.09524,252,73.98081,222,22,315,85,277,863,1234,4.5738044,132,481,7.434053,"101041021",55.882355,417
3,0,0,0,0,0.0,0.0,0,"Deua - Wadbilliga",0,0.0,9,0,9,0,0,0.0,0.0,0,3,0.0,0.0,0,0.0,0,0,0,0,0,3,0,0.0,0,6,0.0,"101041022",0.0,0
448,801,553,192,387,75.40575,66.666664,67,"Eden",604,57.142857,2463,55,1275,288,1188,63.930637,55.03876,134,1666,67.54808,80.07968,251,69.44778,201,34,256,71,281,865,1157,8.292683,129,410,14.211886,"101041023",50.0,416
585,961,715,186,368,72.632675,75.918365,87,"Eurobodalla Hinterland",698,67.69231,2630,61,1301,245,1329,72.51521,57.05128,158,1947,65.053764,76.32653,245,72.57319,187,44,396,89,363,986,1413,13.968254,156,315,16.576086,"101041024",55.06329,558
1576,2579,2045,649,1428,79.488174,77.63158,260,"Merimbula - Tura Beach",2050,64.53046,8470,168,4463,836,4007,72.46634,66.097565,415,5401,70.06415,83.96846,761,75.81929,639,108,1017,271,983,2822,4095,6.5813527,410,1641,11.764706,"101041025",62.650604,1403
1270,2060,1432,467,1079,69.660194,73.65931,186,"Moruya - Tuross Head",1435,57.795277,6378,114,3239,634,3139,64.825714,56.72131,320,4269,58.843254,79.15905,547,67.158585,433,58,734,173,702,2209,2867,5.6310678,305,1030,10.565338,"101041026",58.125,1193
1447,2041,1424,409,1415,69.67173,69.91453,138,"Narooma - Bermagui",1422,54.38839,7144,149,3688,585,3456,61.993904,47.92453,262,4338,58.246178,76.67911,536,65.60627,411,101,787,127,724,2297,2846,7.2609634,265,1391,10.530035,"101041027",52.671757,1243
1299,3223,2347,999,783,83.555695,70.85107,386,"Mudgee",2693,69.43803,8345,126,4339,1410,4006,71.14277,59.491524,607,6522,76.84729,89.05579,1398,77.27691,1245,95,902,351,936,3299,5040,9.134615,590,1040,16.091953,"103031072",63.591434,1218
471,892,502,147,412,65.246635,53.260868,57,"Mudgee Region - East",582,56.26327,2566,79,1262,276,1304,58.44005,39.285713,148,1751,54.115227,70.93023,258,61.907482,183,46,265,44,263,859,1084,11.414392,112,403,19.174757,"103031073",38.51351,486
1337,2726,1802,623,999,81.87821,66.13588,238,"Mudgee Region - West",2232,62.976814,7268,260,3543,942,3725,67.49064,47.058823,476,5396,72.08157,85.62802,828,74.75908,709,153,842,184,1025,2670,4034,17.525774,391,873,26.026026,"103031074",50.0,1422
0,0,0,0,0,0.0,0.0,0,"Wollangambe - Wollemi",0,0.0,0,0,0,0,0,0.0,0.0,0,0,0.0,0.0,0,0.0,0,0,0,0,0,0,0,0.0,0,0,0.0,"103031075",0.0,0
1154,3514,2659,1347,674,83.60842,79.79858,365,"Queanbeyan",2938,72.87695,8469,94,4281,1688,4188,77.77128,70.53726,533,6933,75.74503,88.21207,1773,80.72984,1564,64,841,407,915,3419,5597,7.424594,577,862,13.946588,"101021009",68.4803,1208
586,1671,1244,574,229,84.141235,79.72222,188,"Queanbeyan - East",1406,75.255974,3748,55,1848,720,1900,78.33753,68.43971,282,3259,77.72277,88.37804,783,81.313286,692,36,441,193,471,1588,2650,13.846154,282,260,24.017467,"101021010",66.666664,606
2406,5143,4279,1687,944,88.27532,86.646126,527,"Queanbeyan Region",4540,77.59767,12114,260,6027,1947,6087,81.7383,64.73923,885,10378,83.680984,94.153336,1813,84.97784,1707,154,1867,571,2046,5235,8819,19.444445,882,792,27.542374,"101021011",59.548023,2445
2345,5646,4106,1824,1307,77.860435,73.16486,539,"Gosford - Springfield",4396,65.2452,14543,217,7590,2493,6953,70.32026,58.94106,1000,11485,71.06831,84.78702,2465,74.02699,2090,162,1530,590,1550,5839,8502,9.251856,1001,1751,16.602907,"102011032",53.9,2181
941,2006,1526,578,606,84.99502,73.35025,210,"Blayney",1705,70.13815,5322,175,2710,788,2612,73.11931,55.586594,358,4093,75.69804,86.34361,681,78.93965,588,89,660,199,732,2087,3231,14.285714,358,623,28.877888,"103041076",58.659218,967
2254,5120,3817,1545,1559,74.66797,71.19816,563,"Orange",3823,67.03638,14293,238,7614,2170,6679,68.96116,52.11521,1042,10655,68.62464,79.889114,1984,71.70342,1585,182,1511,579,1437,5535,7640,8.754209,1111,2079,15.266196,"103041077",54.03071,2094
2204,5721,4559,2146,1071,82.90509,77.47292,678,"Orange - North",4743,71.46098,14187,197,7395,2770,6792,74.32344,61.12069,1132,11855,78.02916,89.07692,2600,78.46478,2316,129,1575,709,1552,6134,9302,10.229977,1160,1261,18.394024,"103041078",59.893993,1989
1486,3273,2574,927,975,90.86465,78.3601,358,"Orange Region",2974,76.37954,8428,346,4180,1183,4248,79.102646,52.649574,642,6527,83.333336,90.37239,1101,85.00076,995,204,1135,308,1275,3254,5548,22.030237,585,926,35.48718,"103041079",55.76324,1530
2344,5013,3204,1222,1700,65.70916,63.18511,489,"Grafton",3294,58.788395,14183,203,7470,1934,6713,61.098396,48.861282,1018,10257,61.12446,69.48798,1914,63.351856,1330,132,1378,472,1272,5244,6498,5.9299192,966,2226,11.941176,"104011080",48.035362,2081
2441,4375,2650,768,1610,67.81715,61.146496,376,"Grafton Region",2967,58.377712,11714,268,5729,1256,5985,60.654613,46.42857,770,8744,59.406338,75.71942,1112,64.238335,842,145,1425,312,1481,4369,5617,10.661765,672,1360,16.645964,"104011081",48.83117,2493
2375,3897,2627,824,2410,68.976135,66.88312,336,"Maclean - Yamba - Iluka",2688,56.37895,13026,226,6719,1232,6307,62.57742,55.499153,614,8095,57.61682,78.12773,1143,65.657814,893,136,1339,328,1233,4198,5315,5.394685,591,2521,9.377593,"104011082",54.723125,2140
902,1511,1142,390,480,73.527466,64.35644,105,"Bellingen",1111,66.18626,4249,80,2258,606,1991,65.897285,39.11111,248,3244,69.140625,79.79798,495,69.451294,395,67,597,88,531,1733,2253,12.761905,225,525,16.666666,"104021083",42.33871,768
2209,4703,3411,1367,1496,72.99596,70.50026,543,"Coffs Harbour - North",3433,62.426437,13090,173,6891,1939,6199,67.5981,58.463253,1005,9749,67.60635,80.022896,1747,70.20207,1398,140,1379,525,1319,5046,6844,7.588076,898,1845,11.564171,"104021084",54.02985,1951
1252,2606,2032,793,928,74.90407,73.020256,320,"Coffs Harbour - South",1952,63.178913,7638,130,4104,1086,3534,70.09313,64.527626,567,5505,65.26717,82.542885,991,72.370575,818,86,791,362,684,2899,3984,7.1369295,561,1205,14.00862,"104021085",56.43739,1048
573,1118,844,287,309,79.60644,73.77892,110,"Coramba - Nana Glen - Bucca",890,70.680626,2815,51,1388,389,1427,72.57094,60.696518,183,2281,74.23208,84.240685,349,76.01929,294,30,405,122,435,1163,1734,13.333333,201,225,16.504854,"104021086",60.10929,586
868,1992,1426,504,601,74.04619,75.56222,240,"Cooma",1475,71.65899,5169,105,2576,667,2593,76.297485,63.772453,389,3861,71.21034,69.680855,752,75.13598,524,87,622,213,606,1869,2901,12.305516,334,707,17.470882,"101031014",61.69666,851
677,1423,1012,318,460,87.06957,73.95349,134,"Calga - Kulnura",1239,70.75333,3565,135,1682,430,1883,75.29762,59.07173,235,2767,80.16086,84.162895,442,81.35165,372,75,479,140,598,1344,2251,22.189348,237,338,29.347826,"102011030",57.02128,746
1851,3498,2809,960,1532,80.44597,76.31161,386,"Erina - Green Point",2814,68.17936,10964,170,5934,1258,5030,74.29252,66.666664,705,7279,76.44527,86.97515,1167,77.24962,1015,139,1262,448,1243,3781,5623,6.4561076,672,2153,11.096605,"102011031",54.751774,1626
796,2128,1469,604,269,79.32331,75.21793,283,"Kariong",1688,73.36684,4735,54,2338,803,2397,71.69351,55.77778,520,4177,84.56712,83.47719,811,75.58056,677,30,584,251,674,2049,3157,10.380623,450,289,20.07435,"102011033",54.423077,797
932,1820,1459,550,773,81.42857,78.01418,224,"Kincumber - Picketts Valley",1482,66.20171,5782,63,3189,705,2593,73.09619,65.73816,381,3816,78.20344,88.41642,682,77.07023,603,56,617,236,592,1996,2941,4.6940484,359,1193,8.150064,"102011034",58.792652,757
981,2050,1591,606,416,83.46342,74.63054,246,"Narara",1711,69.21509,5105,72,2639,812,2466,72.252495,63.569683,415,4252,82.129745,88.26406,818,77.65757,722,46,679,260,671,2202,3302,10.526316,409,437,17.307692,"102011035",59.277107,817
1291,2789,2293,913,747,85.44281,80.93971,323,"Wamberal - Forresters Beach",2383,72.96669,7297,110,3761,1128,3536,77.10155,67.20721,532,5763,81.99673,91.5942,1035,81.1383,948,65,942,373,1002,2974,4676,8.2592125,555,787,14.725569,"102011041",60.714287,1222
1848,3766,2593,996,1426,71.747215,69.11867,341,"Woy Woy - Blackwall",2702,60.11905,11012,120,5820,1441,5192,65.895805,56.19195,671,7701,63.70065,82.97568,1398,68.7573,1160,123,1111,363,1081,3935,5295,6.525199,646,1885,8.415147,"102011042",50.81967,1697
527,879,550,147,351,71.89989,61.25,65,"Dorrigo",632,56.356735,2486,97,1256,240,1230,61.728394,36.29032,144,1770,61.585365,68.72428,243,66.77966,167,61,297,45,303,891,1182,16.712328,124,365,27.635328,"104021087",45.13889,492
1351,2444,1999,747,723,83.10147,77.24922,227,"Korora - Emerald Beach",2031,69.72613,6575,131,3408,967,3167,73.60088,59.045227,383,5160,75.19116,89.140274,884,78.10078,788,75,942,235,885,2716,4030,10.83815,398,692,18.118948,"104021088",59.26893,1177
1769,4167,3485,1442,434,87.32901,84.87345,568,"Queanbeyan West - Jerrabomberra",3639,80.553986,9320,95,4719,1699,4601,81.44426,69.667076,881,8446,87.38028,94.3084,1511,84.34762,1425,53,1425,565,1551,4279,7124,12.045455,811,440,21.8894,"101021012",64.47219,1775
314,694,474,158,252,86.59943,74.528305,75,"Bombala",601,68.15286,1845,74,899,212,946,75.71885,56.0,114,1320,74.22096,83.70044,227,81.43939,190,46,214,56,262,626,1075,16.849817,100,273,29.36508,"101031013",65.789474,353
2801,6948,4638,1908,1720,72.99943,72.824425,822,"Goulburn",5072,65.476616,17353,261,8685,2620,8668,70.2089,61.772152,1428,13554,71.561,72.93659,2823,71.639366,2059,164,1834,732,1930,6606,9710,7.8884077,1185,2079,15.174418,"101051539",57.563026,2697
1800,3533,2586,889,1351,88.14039,78.395065,367,"Goulburn Region",3114,66.388885,9540,400,4656,1134,4884,74.848045,53.934742,600,6988,75.96154,87.18191,1061,81.568405,925,221,1195,281,1422,3455,5700,18.401333,521,1201,29.607698,"101051540",61.166668,1872
804,1733,1471,593,490,86.381996,79.278076,220,"Yass",1497,72.38806,4705,95,2482,748,2223,77.17734,66.666664,320,3639,78.01608,89.955025,667,81.56087,600,60,582,236,582,1906,2968,10.416667,354,576,19.387754,"101061541",68.75,746
1679,3427,2902,1076,825,91.33353,84.19405,345,"Yass Region",3130,76.414536,8522,343,4270,1278,4252,82.16308,60.0,586,6959,81.62668,92.491165,1132,86.67912,1047,198,1283,345,1395,3532,6032,26.829268,575,738,41.575756,"101061542",58.87372,1709
1246,2747,2003,756,925,79.65053,68.78981,317,"Young",2188,66.211876,7739,167,4067,1099,3672,68.01358,55.166668,564,5692,73.38638,83.07985,1052,73.629654,874,91,825,331,830,2945,4191,8.110517,600,1122,18.054054,"101061543",56.205673,1131
1025,1993,1421,437,797,85.04767,69.69697,202,"Young Region",1695,65.46342,5573,213,2783,627,2790,71.22807,48.104958,346,3988,72.58064,86.84654,593,78.1344,515,148,671,165,765,1995,3116,18.781727,343,788,26.72522,"101061544",58.381504,1054
1072,2195,1749,644,523,85.6492,78.63248,280,"Avoca Beach - Copacabana",1880,74.906715,5478,113,2760,819,2718,76.98064,64.8294,471,4467,82.82026,91.07392,717,81.240204,653,55,803,247,834,2272,3629,11.270492,381,488,21.60612,"102011028",59.447983,1007
1557,2917,2299,780,1173,83.81899,77.68924,332,"Box Head - MacMasters Beach",2445,69.74952,8429,194,4339,1004,4090,74.37723,60.18868,572,6008,77.2409,88.985825,917,78.96139,816,114,1086,319,1103,3091,4744,9.134615,530,1248,16.53879,"102011029",58.041958,1428
2777,5347,4034,1474,1785,74.34075,71.79737,607,"Sawtell - Boambee",3975,65.39431,14994,190,7862,2053,7132,68.87485,59.3963,1092,11204,68.96413,82.69447,1774,71.4834,1467,134,1816,610,1711,5857,8009,6.683292,1027,2005,10.644258,"104021089",55.586082,2481
768,1263,867,246,586,72.20902,69.688385,97,"Urunga",912,63.151043,3736,66,1887,353,1849,67.00155,54.913296,206,2557,67.00581,78.04878,369,69.57372,288,41,485,95,461,1294,1779,6.9139967,173,593,11.262798,"104021090",47.08738,688
1740,3456,2350,926,1170,72.3669,70.47184,320,"Woolgoolga - Arrawarra",2501,61.49425,9448,112,4822,1314,4626,65.24153,52.91971,595,7058,64.38356,82.47012,1255,68.73052,1035,64,1070,290,1034,3602,4851,5.2459016,548,1220,9.57265,"104021091",53.781513,1606
438,1074,686,293,213,67.504654,65.99099,75,"Bourke - Brewarrina",725,62.78539,2580,67,1293,444,1287,63.225807,35.46798,201,2159,64.52282,69.565216,391,65.35433,272,46,275,72,311,1085,1411,22.115385,203,208,31.455399,"105011092",37.313435,482
477,1383,883,392,266,82.28489,69.014084,125,"Cobar",1138,67.71488,3213,64,1564,568,1649,69.80237,56.363636,229,2648,77.42504,86.882454,587,76.321754,510,44,323,124,439,1265,2021,14.715719,220,299,24.06015,"105011093",54.58515,567
483,1035,727,265,314,77.294685,68.298965,81,"Coonamble",800,67.08074,2736,96,1387,388,1349,67.880486,42.0,184,2106,70.34884,77.61194,335,72.507126,260,54,324,84,363,1071,1527,17.088608,200,316,30.573248,"105011094",44.02174,516
547,1327,947,357,447,85.8327,72.85714,133,"Nyngan - Warren",1139,72.39488,3530,129,1756,490,1774,73.984375,44.444443,244,2607,79.304634,83.08977,479,80.01534,398,86,396,108,479,1280,2086,18.067226,243,476,28.85906,"105011095",54.508198,604
765,1778,1012,391,604,64.34196,59.603657,118,"Walgett - Lightning Ridge",1144,58.954247,4496,151,2114,656,2382,60.309895,36.18677,289,3456,52.668213,67.145134,627,62.38426,421,77,451,93,454,1678,2156,17.660551,257,436,25.0,"105011096",40.83045,862
1667,4084,2271,989,1016,67.16454,60.012135,424,"Berkeley - Lake Heights - Cringila",2743,50.929813,10494,58,5394,1648,5100,54.908123,47.38124,834,8220,61.637142,77.61935,1613,60.997566,1252,44,849,389,1009,4136,5014,3.4976153,821,1258,5.7086616,"107011545",50.83933,1637
1121,2785,1404,613,860,59.92819,55.981735,235,"Port Kembla - Warrawong",1669,47.725246,7442,39,3797,1095,3645,51.259583,44.16826,512,5524,53.095844,70.2925,1094,55.62998,769,25,535,231,626,2739,3073,2.362949,523,1058,4.5348835,"107011546",45.898438,1179
951,1870,1389,421,722,88.77005,75.71942,173,"Deniliquin Region",1660,72.76551,5025,212,2433,556,2592,78.03371,55.311356,311,3650,78.40467,88.32391,531,83.53425,469,125,692,151,806,1780,3049,19.14242,273,653,29.36288,"109031183",55.62701,1028
676,1417,1181,501,744,89.06139,82.40131,166,"Moama",1262,70.11834,4477,105,2316,608,2161,77.49344,62.916668,235,2941,76.982895,92.02226,539,83.066986,496,55,474,151,495,1524,2443,6.9444447,240,792,14.112904,"109031184",70.6383,643
1207,2404,1808,637,1197,84.10982,73.89791,257,"Tocumwal - Finley - Jerilderie",2022,69.09693,7226,232,3625,862,3601,74.28102,54.246574,427,4838,73.40242,83.39439,819,79.16495,683,139,834,198,850,2434,3830,11.670865,365,1191,19.381788,"109031185",60.187355,1158
2645,6880,4839,1787,1507,69.91279,69.263565,895,"Armidale",4810,71.72023,17740,281,9353,2580,8387,64.935585,43.601257,2102,14332,75.71189,76.40167,2390,67.32487,1826,184,1897,971,1808,7452,9649,9.679116,2227,1901,18.646317,"110011186",42.578495,2388
3137,6207,4462,1727,2458,75.769295,68.55895,654,"Umina - Booker Bay - Patonga",4703,61.715015,18352,260,9687,2519,8665,66.62685,58.021133,1160,12904,68.73422,82.805626,2274,71.02449,1883,195,1936,604,1906,6697,9165,6.521739,1041,2990,10.577705,"102011040",56.37931,2773
1369,3106,2275,944,985,77.59176,72.67129,363,"Wyoming",2410,66.0336,8718,104,4627,1299,4091,69.44444,57.07237,667,6382,72.83431,86.16,1250,73.40959,1077,80,904,347,866,3276,4685,5.92154,608,1351,10.558375,"102011043",54.422787,1189
2823,5947,4588,1875,1792,79.737686,73.78985,703,"Bateau Bay - Killarney Vale",4742,66.09989,16645,205,8906,2541,7739,70.29263,61.478935,1220,12474,74.69162,87.45792,2376,74.79558,2078,132,1866,715,1756,6527,9330,5.5485497,1163,2379,11.439733,"102021044",57.62295,2351
1298,3183,2212,934,627,73.578384,65.36039,417,"Blue Haven - San Remo",2342,60.862865,8062,70,4252,1429,3810,62.43297,55.269608,798,6726,70.912224,84.300896,1223,67.707405,1031,37,790,451,824,3543,4554,5.218618,816,709,11.164274,"102021045",52.25564,1162
1228,2576,1697,656,962,73.48602,68.7631,280,"Budgewoi - Buff Point - Halekulani",1893,59.12052,7300,62,3762,954,3538,64.475685,57.77778,486,5208,66.925735,83.2618,932,68.93241,776,55,726,260,775,2632,3590,4.8672566,450,1130,6.444906,"102021046",57.61317,1158
2078,4515,3495,1348,1139,83.344406,75.68781,590,"Chittaway Bay - Tumbi Umbi",3763,69.923004,11816,157,6162,1781,5654,72.99499,64.37029,942,9303,79.39135,89.94118,1700,78.017845,1529,96,1453,598,1487,4788,7258,6.9868994,929,1374,13.784021,"102021047",62.632698,1873
1127,2480,1853,695,488,82.701614,75.46146,313,"Niagara Park - Lisarow",2051,70.54126,6110,72,3142,921,2968,72.95276,66.26016,527,5020,81.33836,90.02242,892,77.76892,803,37,795,326,863,2540,3904,6.146179,492,602,14.754098,"102011036",59.392788,1061
866,1753,1363,502,594,82.54421,73.715126,162,"Point Clare - Koolewong",1447,70.900696,4880,83,2533,681,2347,73.35845,59.807076,288,3611,76.85422,87.99414,683,77.81778,601,61,614,186,601,1858,2810,9.037037,311,675,13.973064,"102011037",56.25,782
921,1904,1576,606,653,85.03151,78.7013,207,"Saratoga - Davistown",1619,70.46688,5375,83,2818,770,2557,76.025085,68.84817,344,3977,79.49029,91.57609,736,80.33694,674,58,649,263,655,2073,3195,7.785235,382,745,12.710567,"102011038",60.17442,824
1918,3930,3210,1236,1136,85.64886,79.741936,498,"Terrigal - North Avoca",3366,69.60375,10481,209,5415,1550,5066,75.90447,65.57162,792,8159,79.11623,90.982506,1486,80.598114,1352,140,1335,499,1307,4229,6576,11.804384,761,1186,18.397888,"102011039",62.878788,1652
2705,5993,3968,1523,1896,72.01736,64.863716,762,"Gorokan - Kanwal - Charmhaven",4316,58.780037,16647,170,8758,2348,7889,62.527576,57.9273,1335,12339,65.748505,80.67812,2153,67.13672,1737,106,1590,749,1647,6346,8284,4.3946934,1293,2412,8.966245,"102021048",57.07865,2505
505,1035,784,262,202,83.18841,76.38484,126,"Jilliby - Yarramalong",861,74.0594,2482,49,1245,343,1237,74.80916,56.5,204,2083,83.463036,81.072556,317,78.97263,257,35,374,113,429,1048,1645,17.766497,200,197,24.257425,"102021049",61.764706,514
1365,2736,1892,676,1362,75.32895,70.416664,332,"Lake Munmorah - Mannering Park",2061,60.43956,8511,83,4413,960,4098,65.8316,59.562843,566,5610,69.236946,84.75676,925,70.463455,784,64,825,327,862,2874,3953,4.1585445,549,1539,6.0939794,"102021050",58.657246,1245
719,1530,1200,449,297,82.810455,75.97293,189,"Ourimbah - Fountaindale",1267,71.62726,3753,71,1926,591,1827,74.11983,61.812298,346,3149,81.651375,89.245285,530,78.34233,473,45,515,191,534,1619,2467,14.657981,309,307,23.905724,"102021051",54.62428,654
768,1649,1108,444,590,75.136444,73.75415,207,"Summerland Point - Gwandalan",1239,57.682293,4531,45,2292,602,2239,66.03099,59.090908,336,3327,67.19577,85.99641,557,70.54404,479,39,443,182,508,1678,2347,6.3517914,308,614,7.6271186,"102021052",61.607143,756
1947,4035,2845,1117,1481,74.02726,68.026794,385,"The Entrance",2987,61.171032,11611,173,6095,1642,5516,66.132034,57.503506,695,8337,64.95486,81.505104,1568,69.953224,1278,127,1191,410,1151,4302,5832,7.083101,713,1793,11.681296,"102021053",55.395683,1772
1172,2547,1627,626,1066,71.33883,66.17336,290,"Toukley - Norah Head",1817,58.532425,7483,63,3870,946,3613,63.086468,55.748375,462,5126,62.192013,80.61674,908,67.18689,732,58,686,257,732,2579,3444,4.4926414,461,1291,5.9099436,"102021054",62.77056,1177
645,1528,1181,502,324,80.89005,72.126434,196,"Tuggerah - Kangy Angy",1236,70.07752,3890,41,2038,696,1852,71.05897,60.747665,336,3190,79.37063,87.90323,620,75.76803,545,32,452,195,454,1662,2417,8.510638,321,376,12.654321,"102021055",58.333332,572
1269,3161,2401,1058,698,79.43689,78.0236,365,"Bathurst - East",2511,69.42474,7958,112,4099,1356,3859,72.58162,56.36896,714,6469,77.974686,87.95563,1262,75.931366,1110,77,881,385,924,3308,4912,9.734513,683,791,16.045845,"103011059",51.12045,1185
978,2084,1513,455,629,77.35125,79.82456,176,"Bathurst Region",1612,74.33538,5141,190,2428,570,2713,79.33928,52.64624,345,3991,71.906975,71.23494,664,78.30118,473,142,727,189,773,1907,3125,27.255278,359,521,30.206676,"103011060",51.014492,1075
574,1349,855,283,459,79.09563,72.93814,127,"Oberon",1067,66.20209,3442,139,1634,388,1808,73.139435,56.038647,315,2518,77.147766,77.87611,452,76.33042,352,76,380,116,449,1169,1922,16.344086,207,465,30.283224,"103011061",40.31746,582
732,1709,1205,465,584,85.78116,68.382355,171,"Condobolin",1466,67.349724,4636,186,2343,680,2293,69.412445,44.753086,316,3445,75.86207,84.03756,639,77.53265,537,102,493,145,572,1736,2671,16.803953,324,607,31.849316,"103021062",54.113926,754
1151,2328,1616,570,959,75.42955,67.77646,270,"Cowra",1756,59.77411,6894,154,3607,841,3287,65.37217,59.583332,471,4800,67.25912,77.79188,788,70.25,613,72,688,286,719,2472,3372,6.343612,480,1135,16.058393,"103021063",57.32484,1069
781,1479,1035,327,628,83.09669,73.9819,146,"Cowra Region",1229,63.380283,4142,156,2035,442,2107,71.6263,54.054054,273,2924,71.86312,86.33093,417,77.42818,360,93,495,120,567,1445,2264,15.762712,222,590,24.840765,"103021064",53.479855,789
1198,2718,1919,730,968,83.25975,74.71853,354,"Forbes",2263,68.53088,7389,216,3703,977,3686,71.92654,50.30426,571,5386,73.427155,85.836,939,77.64575,806,120,821,248,887,2668,4182,11.594203,493,1035,22.314049,"103021065",61.9965,1208
476,919,661,225,467,83.67791,74.01316,79,"Grenfell",769,63.865547,2758,112,1372,304,1386,72.31947,43.28358,139,1833,68.86598,82.71186,295,78.01418,244,74,304,58,334,914,1430,16.157206,134,458,23.98287,"103021066",56.834534,485
1266,2956,2065,825,787,78.34912,69.91525,364,"Parkes (NSW)",2316,63.27014,7862,118,4119,1180,3743,66.29214,53.961136,643,6071,74.833336,84.09704,1113,72.16274,936,78,801,361,898,3115,4381,7.768924,669,1004,14.993647,"103021067",56.609642,1200
462,950,607,183,334,78.947365,67.52767,89,"Parkes Region",750,64.71861,2468,103,1184,271,1284,67.67001,38.414635,178,1847,69.407265,78.313255,249,73.47049,195,62,299,63,363,897,1357,21.602787,164,287,30.838324,"103021068",50.0,523
668,1565,1123,415,526,89.52077,72.934975,176,"West Wyalong",1401,70.65868,4144,162,2053,569,2091,75.167336,56.031128,283,3059,79.44056,87.30159,567,82.51063,495,92,472,144,568,1494,2524,16.45796,257,559,30.79848,"103021069",62.19081,715
1561,3734,2184,843,1227,62.828068,65.60311,386,"Lithgow",2346,59.83344,9832,105,4871,1285,4961,63.121387,51.79153,756,7194,60.572544,64.12214,1441,62.96914,924,89,934,318,931,3460,4530,6.3075833,614,1411,8.557457,"103031070",51.0582,1537
1132,2287,1509,538,785,77.56887,70.789474,220,"Lithgow Region",1774,61.749115,6002,135,2930,760,3072,67.36607,52.58621,394,4527,71.199326,81.24119,709,72.52043,576,89,699,183,843,2240,3283,12.898551,348,690,17.197453,"103031071",55.837563,1184
2708,7434,5172,2059,1513,71.07883,75.53191,908,"Bathurst",5284,71.381096,18115,254,9168,2726,8947,72.18423,57.943386,1842,14599,72.34626,74.86015,3039,71.621346,2275,177,1933,1003,1847,7165,10456,8.836745,1731,2003,16.787838,"103011058",49.294247,2553
2345,5028,3398,1335,1551,69.769295,70.04197,493,"Broken Hill",3508,61.40725,13647,183,7068,1906,6579,66.36719,55.581127,934,10148,64.33506,75.478065,1778,68.05282,1342,140,1440,483,1490,5120,6906,7.186858,869,1948,11.79884,"105021097",52.783726,2316
278,747,393,144,188,72.690765,55.813953,53,"Far West",543,65.10791,1720,70,785,258,935,59.63581,30.0813,127,1406,69.55224,65.61404,285,66.57184,187,31,181,37,233,659,936,24.603174,123,126,37.234043,"105021098",41.732285,335
1072,2021,1376,473,914,73.97328,70.3869,134,"Coonabarabran",1495,61.19403,5896,212,2961,672,2935,66.634384,37.694702,353,4086,66.127495,73.58185,617,70.26432,454,126,656,121,695,2065,2871,14.0625,321,896,23.194748,"105031099",37.96034,1051
1389,2999,2368,915,617,80.86029,73.02474,381,"Dubbo - East",2425,70.84233,7624,144,4008,1253,3616,71.36829,58.72781,662,6317,79.06197,83.63954,1143,75.874626,956,72,984,397,944,3318,4793,10.434783,676,690,23.338736,"105031100",57.55287,1194
1608,4247,3236,1548,936,81.46927,73.854965,542,"Warnervale - Wadalba",3460,64.11691,10898,99,5715,2096,5183,69.44206,60.77406,913,8907,77.756035,90.3387,1801,75.17683,1627,76,1031,581,1192,4660,6696,7.2037916,956,1055,10.576923,"102021056",59.36473,1533
1136,2517,1563,605,700,70.162895,60.682045,280,"Wyong",1766,54.489437,6614,95,3397,997,3217,58.56126,53.544777,531,5186,65.75876,74.63466,958,64.192055,715,52,619,287,676,2669,3329,7.142857,536,728,13.571428,"102021057",52.730698,1028
769,1662,1222,467,610,85.13839,71.189026,159,"Narromine",1415,68.6606,4615,174,2343,656,2272,70.840576,46.0,325,3387,78.10414,84.52381,588,77.856514,497,89,528,138,585,1725,2637,14.401295,300,618,28.52459,"105031105",48.923077,749
1013,2621,1363,458,795,58.222054,59.403374,204,"Wellington",1526,61.59921,6480,188,3064,771,3416,61.479477,41.108543,549,4838,60.922787,48.217823,1010,59.71476,487,103,624,178,647,2217,2889,12.160566,433,847,23.647799,"105031106",37.15847,1062
1214,3020,2179,998,624,85.695366,74.7006,341,"Branxton - Greta - Pokolbin",2588,63.83855,7306,155,3662,1336,3644,70.56347,60.22305,549,6108,77.99353,91.33603,1235,78.04519,1128,82,775,324,964,3088,4767,14.285714,538,574,24.839743,"106011107",62.112934,1236
2529,6640,3761,1611,1618,60.63253,65.06462,679,"Cessnock",4026,54.013443,16568,157,8310,2476,8258,59.726852,53.40557,1399,12937,58.942585,62.51773,2820,60.1917,1763,94,1366,690,1427,6297,7787,4.669647,1292,2013,9.703338,"106011108",48.534668,2421
1121,2228,1588,587,565,77.513466,71.324425,226,"Cessnock Region",1727,61.64139,5719,115,2926,823,2793,66.694664,56.750572,406,4609,71.454384,83.21678,715,71.92449,595,62,691,248,791,2381,3315,11.376146,437,545,20.353983,"106011109",55.665024,1107
1306,2501,1806,648,839,82.76689,72.72727,240,"Dungog",2070,64.24196,6741,183,3401,891,3340,68.85246,49.06103,430,5124,74.173225,88.014984,801,75.64403,705,110,839,209,942,2623,3876,14.138818,426,778,21.81168,"106011110",55.813953,1270
2125,5240,3243,1423,1196,69.48473,67.21776,595,"Kurri Kurri - Abermain",3641,55.24706,13075,94,6639,2117,6436,61.327534,55.258125,1093,10528,63.419292,79.10375,2053,65.387535,1624,68,1174,578,1328,5288,6884,5.0333085,1046,1351,7.859532,"106011111",54.43733,2094
1832,5246,3192,1410,825,83.45406,68.38021,857,"Singleton",4378,61.954147,11904,125,5833,2062,6071,65.409836,59.02637,1255,10126,79.9161,89.827255,2084,74.75805,1872,65,1135,582,1524,4880,7570,6.8205667,986,953,15.151515,"106011112",68.28685,1907
648,1416,961,367,341,87.28814,74.2915,147,"Singleton Region",1236,63.425926,3398,107,1641,494,1757,70.09482,55.458515,241,2787,80.43796,87.95918,490,78.830284,431,56,411,127,551,1371,2197,20.74074,229,270,31.3783,"106011113",60.99585,685
687,1976,1411,705,364,77.530365,74.44562,198,"Maitland",1532,64.19214,4846,49,2506,947,2340,69.26853,59.801487,360,4013,71.88366,85.68233,894,73.336655,766,24,441,241,519,2037,2943,5.117271,403,469,13.461538,"106021114",55.0,722
3426,7901,5791,2502,1841,78.0281,71.52659,908,"Maitland - East",6165,63.660244,20587,222,10845,3498,9742,68.089355,59.645794,1628,16406,73.94435,86.26476,3218,72.87578,2776,165,2181,943,2259,8505,11956,7.051282,1581,2340,12.058663,"106021115",55.773956,3055
1022,2197,1806,741,505,86.25398,80.983604,271,"Maitland - North",1895,73.287674,5625,108,2923,915,2702,76.98209,64.05868,450,4543,82.32804,92.01995,802,81.46599,738,54,749,262,778,2346,3701,9.358752,409,577,21.386139,"106021116",60.22222,945
2489,6614,4656,2146,1260,78.590866,69.69795,858,"Maitland - West",5198,61.028526,16410,157,8536,3079,7874,66.18337,60.531696,1391,13649,72.76386,85.57081,2987,72.19576,2556,103,1519,888,1627,7035,9854,6.862092,1467,1501,12.460318,"106021117",61.682243,2236
1320,3216,2417,1079,477,83.768654,78.0188,397,"Thornton - Millers Forest",2694,67.19697,7494,77,3801,1383,3693,72.56079,64.01274,649,6547,81.51125,91.15646,1323,78.06629,1206,49,887,402,1014,3331,5111,10.425532,628,470,16.142557,"106021118",61.171032,1244
804,1612,1154,398,540,76.11662,76.53846,203,"Anna Bay",1227,64.054726,4381,58,2229,520,2152,69.559975,62.686565,352,3271,70.86008,86.07069,481,72.7912,414,31,515,210,552,1659,2381,5.4385967,335,570,10.740741,"106031119",57.670456,779
938,1777,1035,371,780,70.23073,62.35294,148,"Lemon Tree Passage - Tanilba Bay",1248,52.452026,5132,56,2575,595,2557,58.375633,49.583332,289,3550,64.85261,77.88779,606,64.30986,472,53,492,119,572,1773,2283,6.608479,240,802,7.179487,"106031120",51.21107,882
2775,5012,3838,1356,2836,78.51157,74.30137,521,"Nelson Bay Peninsula",3935,61.08108,16547,301,8699,1825,7848,69.9344,64.3018,890,10500,69.018654,85.205315,1656,74.02857,1411,216,1695,571,1702,5488,7773,6.7268763,888,3211,10.613541,"106031121",58.539326,2466
1695,3972,2440,975,923,71.09769,61.94409,463,"Raymond Terrace",2824,56.40118,10092,104,5197,1574,4895,59.3963,53.158524,875,8080,67.87727,78.2,1500,65.14851,1173,63,956,446,1084,4108,5264,5.785124,839,1089,11.267606,"106031122",52.914288,1597
866,1682,1304,416,376,87.03924,79.69349,223,"Seaham - Woodville",1464,70.78522,4121,89,2063,522,2058,74.1752,59.45946,356,3440,84.774666,90.29703,505,80.46512,456,55,613,220,696,1758,2768,18.032787,370,305,23.670214,"106031123",62.64045,821
671,1023,667,175,1059,72.43402,64.81481,66,"Tea Gardens - Hawks Nest",741,51.71386,4263,95,2181,270,2082,60.307415,47.878788,132,2129,60.487804,75.36232,276,66.13434,208,66,347,79,372,1106,1408,6.139535,165,1075,8.970727,"106031124",50.0,615
1684,4016,2806,1180,981,81.374504,74.0276,478,"Williamtown - Medowie - Karuah",3268,64.786224,9935,138,4938,1594,4997,69.94018,61.17166,791,8028,76.79856,88.05395,1557,75.66019,1371,86,1091,449,1281,4012,6074,9.287257,734,926,14.067278,"106031125",60.429836,1668
1322,3848,2154,966,598,70.45219,63.51085,385,"Muswellbrook",2711,59.077156,8715,80,4269,1521,4446,60.71026,50.496452,701,7396,68.06032,74.22986,1688,65.7788,1253,51,781,356,993,3548,4865,7.073509,705,721,13.377927,"106041126",54.92154,1459
501,1180,833,327,298,88.05085,73.814896,137,"Muswellbrook Region",1039,70.45908,2904,84,1426,443,1478,72.05882,50.943398,225,2336,81.78294,90.20501,439,80.136986,396,45,353,108,422,1156,1872,16.666666,212,270,28.18792,"106041127",60.88889,516
657,1610,1215,541,436,88.447205,75.98315,203,"Scone",1424,68.94977,4241,83,2195,712,2046,73.148705,59.931507,297,3271,81.818184,91.57734,653,80.67869,598,46,453,175,540,1661,2639,8.614232,292,534,19.036697,"106041128",68.35017,660
1041,2267,1672,646,694,87.51654,73.15968,216,"Scone Region",1984,67.819405,5937,192,2976,883,2961,72.72727,50.133335,361,4566,77.68281,88.86284,853,80.07008,758,132,706,188,818,2299,3656,19.497784,375,677,27.665707,"106041129",59.833794,1053
2918,6713,4610,1986,2067,75.15269,72.06096,778,"Dapto - Avondale",5045,59.150105,18202,161,9422,2756,8780,65.72569,57.53731,1419,13727,70.579384,84.59788,2636,70.33583,2230,127,1726,771,1876,7014,9655,5.2740865,1340,2408,7.7890663,"107011131",54.827343,2658
1077,2642,2100,1024,431,82.1726,81.33439,334,"Horsley - Kembla Grange",2171,65.08821,6421,47,3348,1259,3073,73.04348,64.19295,579,5517,80.16789,92.432434,1110,77.41526,1026,29,701,346,764,2875,4271,6.1310782,539,473,10.904872,"107011132",57.685665,953
0,4,0,0,4,0.0,0.0,0,"Port Kembla Industrial",0,0.0,8,0,0,0,8,0.0,0.0,0,4,0.0,0.0,0,0.0,0,0,0,0,0,0,0,0.0,0,0,0.0,"107011133",0.0,4
2103,4643,3381,1391,1029,78.80681,76.47059,635,"Unanderra - Mount Kembla",3659,65.52544,11755,121,6083,1819,5672,69.5679,58.422176,1061,9503,75.8961,87.02474,1657,74.08187,1442,64,1378,548,1461,4860,7040,5.2330337,938,1223,11.758989,"107011134",59.849197,1925
562,1143,859,292,434,86.87664,68.2243,119,"Gilgandra",993,69.39502,3239,134,1662,428,1577,72.06376,47.0297,215,2335,77.38971,83.072914,384,79.31477,319,82,390,95,421,1192,1852,17.446808,202,470,30.875576,"105031104",55.34884,544
962,1653,1142,343,786,73.744705,63.636364,120,"Tenterfield",1219,58.627857,4947,184,2508,539,2439,65.44412,45.491802,255,3398,61.668427,73.39246,451,69.48205,331,124,564,111,584,1745,2361,16.251638,244,763,23.40967,"110021194",47.058823,947
2751,6635,4968,2213,1463,77.33233,74.112526,729,"Seaford (SA)",5131,66.812065,16788,142,8690,2986,8098,70.668564,64.037125,1342,13665,74.77292,85.30129,2871,73.90414,2449,89,1838,828,1811,7030,10099,5.361446,1293,1660,9.706083,"403041087",54.321907,2422
546,1313,968,368,347,101.21858,74.49393,91,"Kulin",1329,82.41758,3120,178,1460,494,1660,83.73702,52.58621,131,2469,87.07692,92.85714,532,93.033615,494,89,450,61,566,1156,2297,29.276316,116,304,51.29683,"509031247",69.46565,650
1581,2594,1968,672,1343,73.70856,71.87166,226,"Old Bar - Manning Point - Red Head",1912,60.65781,8249,148,4312,935,3937,66.73449,55.196304,415,5543,64.131996,82.038216,785,69.9982,644,98,959,239,894,2949,3880,7.190022,433,1363,11.020104,"108051168",54.457832,1394
2639,5147,3278,1193,2178,65.24189,60.712467,541,"Taree",3358,54.452446,15524,204,8199,1965,7325,57.6301,46.402214,1096,10835,61.123203,68.92816,1754,61.245964,1209,145,1437,503,1404,5688,6636,5.774592,1084,2511,9.366391,"108051169",49.361313,2297
357,786,493,177,179,87.53181,61.458332,70,"Murray",688,65.266106,1837,55,872,288,965,68.0,66.25,109,1511,80.48781,86.36364,308,78.16016,266,30,233,53,297,725,1181,20.408163,80,147,30.726257,"509031248",64.220184,369
1652,3362,2707,1084,805,82.95657,80.35582,310,"Thirroul - Austinmer - Coalcliff",2789,72.09443,8581,140,4414,1349,4167,75.868835,60.670193,589,6930,79.33207,91.06239,1186,79.30736,1080,88,1191,344,1259,3568,5496,10.401892,567,846,17.391304,"107041148",52.63158,1587
1973,4689,4032,1824,1114,85.434,80.458755,616,"Dubbo - South",4006,73.03599,12552,213,6749,2267,5803,76.84391,63.2572,937,9936,78.977936,89.50739,2030,80.89774,1817,130,1441,637,1360,5247,8038,8.655127,1007,1502,19.120287,"105031101",65.74173,1722
894,2389,1876,859,568,81.74969,75.41703,322,"Dubbo - West",1953,69.46309,6197,120,3240,1139,2957,73.1099,60.412758,534,4955,77.710106,84.4294,1034,77.27548,873,74,621,322,638,2566,3829,10.979228,533,674,21.12676,"105031102",60.299625,821
799,1634,1305,450,448,90.51408,80.645164,189,"Dubbo Region",1479,75.34418,4044,165,1962,558,2082,81.3591,65.18219,302,3238,81.07448,89.86355,513,85.979,461,92,602,161,664,1604,2784,25.698324,247,358,36.830357,"105031103",62.582783,819
517,1217,714,281,541,71.48727,73.177086,124,"Windang - Primbee",870,57.253384,3455,47,1697,384,1758,64.968155,55.050507,214,2316,60.90604,82.55528,407,68.39378,336,28,296,109,363,1099,1584,4.6822743,198,598,8.687615,"107011547",57.943924,596
0,0,0,0,4,0.0,0.0,0,"Illawarra Catchment Reserve",4,0.0,4,4,0,0,4,0.0,0.0,0,0,0.0,0.0,0,0.0,0,0,0,0,0,0,4,0.0,0,0,100.0,"107021135",0.0,0
1769,4381,3278,1452,778,82.08172,76.54191,634,"Albion Park - Macquarie Pass",3596,67.269646,10731,87,5572,1897,5159,70.46432,58.62069,1019,9033,79.03615,91.83314,1702,76.09875,1563,58,1190,578,1312,4652,6874,6.304348,986,920,11.182519,"107031136",62.21786,1660
888,2011,1363,579,512,76.67827,70.69597,262,"Albion Park Rail",1542,58.445946,5190,60,2667,819,2523,64.11101,57.279236,428,4137,71.0362,83.248085,782,70.21996,651,25,519,240,569,2126,2905,4.6210723,419,541,11.71875,"107031137",61.214954,801
1082,2064,1576,555,899,80.37791,78.723404,232,"Kiama",1659,65.0647,6144,103,3181,705,2963,73.2342,68.49315,389,4216,73.80254,87.269936,652,76.7315,569,67,704,250,755,2152,3235,6.511176,365,1029,11.457174,"107031138",59.640102,1023
2583,5769,4432,1928,1363,80.464554,78.02509,652,"Woonona - Bulli - Russell Vale",4642,69.29926,14987,141,7855,2471,7132,72.90673,59.90244,1146,11848,77.03765,90.07253,2206,76.58677,1987,100,1790,614,1862,6079,9074,5.6306305,1025,1776,10.344828,"107041150",56.893543,2417
596,1245,934,320,398,89.95984,71.111115,117,"Armidale Region - North",1120,71.81208,3276,167,1633,450,1643,75.566345,46.31579,212,2481,78.73754,83.99072,431,82.7892,362,98,428,88,474,1236,2054,24.685139,190,397,41.9598,"110011187",55.18868,602
920,1638,1330,445,555,86.20268,77.66143,145,"Armidale Region - South",1412,68.152176,4546,156,2353,573,2193,74.59338,56.551723,284,3421,76.54609,91.54929,497,80.152,455,94,627,164,656,1783,2742,16.491228,290,570,28.108109,"110011188",51.05634,857
403,815,650,192,346,99.5092,69.818184,75,"Walcha",811,71.21588,2327,143,1166,275,1161,79.268295,61.267605,130,1635,84.23529,90.38461,260,89.357796,235,84,287,87,358,820,1461,24.277456,142,346,41.32948,"110011189",57.692307,425
1137,2369,1550,505,948,71.00042,66.62269,213,"Glen Innes",1682,60.598064,6652,215,3335,758,3317,67.68559,53.670887,402,4659,62.829525,65.0181,829,69.37111,539,144,689,212,715,2290,3232,13.779904,395,1045,22.679325,"110021190",52.985073,1138
1356,3033,2191,821,1066,77.4151,66.965744,388,"Inverell",2348,66.0767,8651,171,4552,1226,4099,67.456894,52.25225,673,6281,71.12387,80.80631,1141,72.265564,922,126,896,348,867,3248,4539,9.662577,666,1304,16.041275,"110021191",57.6523,1219
705,1435,858,278,480,70.10453,61.77778,131,"Inverell Region - East",1006,57.02128,3776,116,1861,450,1915,61.417324,40.909092,300,2832,61.864407,75.175644,427,65.81921,321,79,402,99,438,1397,1864,17.025862,242,464,24.166666,"110021192",43.666668,708
763,1486,1100,363,673,84.6568,69.011406,140,"Inverell Region - West",1258,67.10354,4363,178,2204,526,2159,72.08388,48.52321,247,3012,71.80784,83.03571,448,78.28685,372,110,512,115,568,1526,2358,16.224188,237,678,26.448736,"110021193",56.68016,791
880,1769,1292,493,492,82.02374,80.81967,228,"Kiama Downs - Minnamurra",1451,68.63636,4543,58,2282,610,2261,73.32577,60.661766,367,3531,75.88833,92.345276,614,77.68337,567,30,604,165,598,1762,2743,5.769231,272,520,11.788618,"107031139",62.12534,788
1116,2102,1656,583,744,86.53663,81.88202,261,"Kiama Hinterland - Gerringong",1819,68.996414,5925,144,3079,712,2846,75.47858,63.114754,419,4296,78.696495,92.36641,655,80.8892,605,72,770,231,809,2194,3475,8.135593,366,885,19.35484,"107031140",62.29117,1028
2105,5085,3836,1715,1007,82.79253,78.561615,654,"Shellharbour - Flinders",4210,67.078384,12439,110,6347,2183,6092,72.35006,63.11637,1076,10387,80.2625,91.51874,2028,77.46221,1856,69,1412,640,1590,5302,8046,6.602871,1014,1045,10.923535,"107031141",60.78067,1981
1413,2935,2161,862,824,77.20613,75.283844,355,"Shellharbour - Oak Flats",2266,60.509556,7881,81,4122,1145,3759,67.74295,62.341774,605,6125,72.95797,85.12629,1069,72.27755,910,50,855,394,920,3190,4427,5.3648067,632,932,9.830097,"107031142",58.677685,1261
2616,5659,3519,1447,1788,67.53844,65.802635,630,"Warilla",3822,51.64373,15531,118,8084,2199,7447,58.464863,53.73754,1240,11678,62.573345,77.766846,2033,62.86179,1581,74,1351,647,1493,6019,7341,3.5835352,1204,2065,6.5995526,"107031143",50.80645,2386
2517,6455,4358,1827,1749,72.22308,74.17783,761,"Balgownie - Fairy Meadow",4662,63.13071,16819,192,8615,2463,8204,67.33622,55.093834,1559,12927,71.16183,80.209175,2486,69.776436,1994,120,1589,822,1715,6472,9020,5.5996265,1492,2143,10.977701,"107041144",48.813343,2410
2056,4603,3218,1399,1195,73.58244,72.90255,521,"Corrimal - Tarrawanna - Bellambi",3387,59.58171,12111,97,6313,1919,5798,66.323166,59.40707,936,9455,66.77385,84.56413,1801,69.857216,1523,73,1225,521,1246,4852,6605,4.9965777,877,1461,8.117155,"107041145",55.66239,1866
2005,3272,2101,583,1677,67.14548,64.92205,226,"Taree Region",2197,56.209476,9795,223,4846,898,4949,62.012985,46.391754,498,6660,59.68319,70.99143,817,64.53454,580,166,1127,225,1168,3388,4298,11.38546,485,1458,13.297555,"108051170",45.381527,1957
768,1382,916,302,546,68.08972,61.257607,134,"Wingham",941,56.770832,4143,45,2215,493,1928,58.868896,50.16949,277,2938,64.549484,75.93458,428,63.206264,325,30,436,148,437,1556,1857,4.552352,295,659,8.241758,"108051171",48.37545,677
1654,4398,3671,1687,912,85.40246,81.5764,622,"Albury - East",3756,72.309555,11220,139,5910,2068,5310,76.38369,63.83764,943,9204,80.79132,91.57839,1888,80.69318,1729,96,1196,692,1266,4806,7427,8.695652,1084,1104,15.241228,"109011172",65.9597,1567
2370,6575,4498,1893,1549,72.57795,74.615685,821,"Figtree - Keiraville",4772,68.059074,16516,158,8392,2537,8124,69.48865,53.831417,1756,13048,74.88809,82.011604,2585,71.04537,2120,149,1613,843,1673,6473,9270,7.7644606,1566,1919,10.20013,"107041146",46.753986,2234
1152,2851,2219,939,493,84.8825,82.87732,402,"Helensburgh",2420,78.03819,6591,83,3247,1133,3344,79.5911,66.600395,622,5639,82.69395,91.382576,1056,82.26636,965,46,899,335,970,2788,4639,10.021787,503,459,16.8357,"107041147",64.630226,1173
1365,4711,2983,1317,1045,70.81299,72.24355,575,"Wollongong - East",3336,61.0989,11442,157,5686,1823,5756,67.50396,59.707554,1169,9130,66.54357,77.83364,2188,69.21139,1703,97,834,735,901,4419,6319,7.65588,1231,1267,15.023924,"107041548",49.18734,1354
850,1699,1257,448,826,87.58093,76.975945,197,"Corowa Region",1488,68.35294,5000,155,2475,582,2525,73.897705,55.01859,283,3400,73.247665,90.89286,560,80.73529,509,80,581,148,627,1701,2745,10.335917,269,774,18.765133,"109031181",69.611305,856
1187,2122,1355,422,772,67.672005,63.363365,173,"Nambucca Heads Region",1436,59.056446,5777,136,2883,666,2894,62.471184,49.36709,345,4291,59.090908,71.68576,611,65.04311,438,76,701,156,689,2169,2791,10.644258,316,714,17.616581,"108021159",50.144928,1166
737,1178,801,265,862,66.72326,67.43002,102,"South West Rocks",786,54.545456,4170,55,2130,393,2040,61.568024,52.63158,187,2479,55.555557,77.84091,352,64.017746,274,44,402,90,355,1301,1587,5.3075995,171,829,6.3805103,"108021160",54.545456,639
50,117,110,40,33,105.9829,86.95652,6,"Lord Howe Island",124,84.0,304,13,154,46,150,97.34513,82.35294,6,230,89.28571,100.0,55,101.73913,55,14,42,14,50,113,234,34.146343,17,41,39.39394,"108031161",100.0,56
2464,3948,2733,879,2513,69.70618,71.405365,349,"Laurieton - Bonny Hills",2752,58.19805,13385,173,6924,1231,6461,64.124825,53.43915,687,8210,62.52285,80.33551,1073,66.80877,862,117,1434,303,1368,4262,5485,4.3951917,567,2662,6.884202,"108041162",50.800583,2188
924,1989,1486,557,685,80.64354,75.16869,240,"Deniliquin",1604,68.29005,5554,123,2880,741,2674,72.91462,58.44504,388,4027,71.33407,85.590775,694,76.732056,594,80,631,218,647,2038,3090,9.501187,373,842,17.956203,"109031182",61.85567,907
1656,5865,3442,1539,998,64.67178,68.15766,726,"Wollongong - West",3793,62.016907,13438,120,6575,2258,6863,63.21396,52.25343,1759,11310,66.999374,74.8302,2503,63.969936,1873,76,1027,800,1074,5445,7235,6.7256637,1531,1130,12.024048,"107041549",41.27345,1603
709,1335,882,269,522,73.10861,68.101265,105,"Bulahdelah - Stroud",976,60.93089,3689,87,1832,395,1857,66.86884,54.418606,205,2654,65.60425,76.92308,377,70.00754,290,64,432,117,494,1319,1858,12.475634,215,513,16.666666,"108011151",51.219513,753
1868,3239,2374,819,2092,67.86045,69.7615,307,"Forster",2198,59.261242,11319,154,5988,1174,5331,65.81647,55.221237,578,6846,59.48749,74.559685,1022,66.78352,762,136,1107,312,975,3607,4572,5.711886,565,2381,7.361377,"108011152",53.114185,1639
898,1589,957,311,784,67.27502,63.340122,99,"Forster-Tuncurry Region",1069,54.67706,4653,92,2280,491,2373,60.0,43.203884,225,3184,58.423325,76.940636,438,63.630653,337,66,491,89,541,1595,2026,9.635036,206,685,11.734694,"108011153",44.0,926
808,1283,821,250,1127,63.912704,64.76684,117,"Tuncurry",820,50.618813,5103,70,2693,386,2410,59.23521,56.770832,231,2669,54.227406,71.31148,366,61.483704,261,53,409,109,372,1386,1641,4.055088,192,1307,6.21118,"108011154",50.64935,686
1778,4053,2209,792,1218,56.057243,56.25,355,"Kempsey",2272,54.78065,10661,159,5390,1408,5271,55.966557,45.729305,856,8000,54.124023,55.92448,1536,56.0125,859,95,974,348,899,3947,4481,6.5835066,761,1443,13.054187,"108021155",41.471962,1661
1431,2611,1651,500,955,67.13903,66.22517,210,"Kempsey Region",1753,60.377357,6935,177,3369,755,3566,64.36647,45.382587,418,5176,56.962025,73.84393,692,65.76507,511,115,864,172,855,2565,3404,14.303483,379,804,18.53403,"108021156",50.239235,1501
646,1213,773,271,548,68.75515,65.61743,119,"Macksville - Scotts Head",834,55.572754,3643,65,1882,413,1761,61.10672,50.970875,236,2478,59.574467,78.142075,366,64.850685,286,38,359,105,364,1265,1607,6.158833,206,617,11.861314,"108021157",50.42373,611
938,1531,930,282,958,59.046375,55.294117,125,"Nambucca Heads",904,51.38593,5297,65,2808,510,2489,53.819443,42.5,272,3259,49.075214,70.53571,448,56.274933,316,47,482,119,398,1728,1834,4.351852,280,1080,6.784969,"108021158",45.955883,811
3821,7257,5749,2150,2984,79.16495,75.25376,762,"Port Macquarie - East",5745,68.41141,21863,305,11622,2857,10241,71.763824,59.864967,1341,15268,72.8421,87.070625,2591,75.28163,2256,187,2614,798,2422,8011,11494,5.178621,1333,3611,10.22118,"108041163",56.823265,3325
2126,4024,3146,1233,2194,74.179924,73.69994,401,"Port Macquarie - West",2985,61.47695,13588,208,7370,1673,6218,68.49554,58.312344,756,8617,63.719337,83.10231,1515,71.150055,1259,143,1307,463,1117,4593,6131,5.1494417,794,2777,9.480401,"108041164",53.042328,1753
823,1536,1069,311,487,79.10156,69.41964,138,"Port Macquarie Region",1215,67.80073,3945,129,1922,448,2023,70.09836,50.0,246,3061,70.443924,79.49309,434,74.61614,345,73,558,127,603,1525,2284,18.387909,254,397,26.488707,"108041165",56.09756,856
1480,2857,2101,759,1066,74.72874,69.31507,285,"Wauchope",2135,64.25676,8303,122,4380,1095,3923,66.42428,49.489796,555,6020,70.57506,81.30841,963,70.36545,783,100,951,291,945,3163,4236,8.216927,588,1217,11.444653,"108041166",51.351353,1339
666,1276,814,233,649,78.76176,58.542713,115,"Gloucester",1005,60.21021,3931,140,2006,398,1925,65.329056,48.9011,225,2522,68.39827,77.09497,358,72.1253,276,91,401,89,474,1246,1819,11.973684,182,760,21.57165,"108051167",51.11111,693
1199,2808,2075,821,726,76.74502,72.207565,378,"Albury - North",2155,69.55797,7345,96,3811,1137,3534,70.722565,58.695652,630,5742,71.77419,82.862526,1062,73.66771,880,69,834,351,801,2934,4230,7.867731,598,877,13.223141,"109011173",60.0,1116
1381,2886,2363,839,854,80.45738,76.831505,348,"Albury - South",2322,73.352646,7888,170,4148,1092,3740,77.02086,65.54622,585,5954,74.09493,83.45936,1058,78.6866,883,121,1013,390,921,3068,4685,11.203704,595,1080,19.906322,"109011174",59.48718,1243
1634,3178,2505,830,1010,87.79106,75.24932,364,"Albury Region",2790,73.80661,8412,294,4224,1103,4188,76.441864,55.0,617,6455,80.70396,87.42268,970,82.029434,848,172,1206,297,1284,3277,5295,18.162619,540,947,29.108912,"109011175",58.995136,1591
530,894,784,252,372,93.51231,79.74683,93,"Robertson - Fitzroy Falls",836,71.50944,2610,114,1344,316,1266,79.19192,63.194443,143,1884,80.1636,90.458015,262,85.98726,237,62,379,91,392,990,1620,17.514124,144,354,30.64516,"114021288",65.034966,489
1041,1628,1393,400,849,92.44472,76.92308,180,"Southern Highlands",1505,67.72334,5150,234,2673,520,2477,76.96133,60.240963,269,3438,77.66082,84.72222,504,84.29319,427,138,705,150,664,1810,2898,15.99073,249,863,27.561838,"114021289",66.9145,855
14,31,12,6,22,87.09677,100.0,0,"French Island",27,42.857143,83,4,30,6,53,60.0,0.0,0,51,65.21739,100.0,8,76.47059,8,0,6,0,15,20,39,0.0,0,10,18.181818,"205031088",0.0,23
4,21,18,11,0,100.0,78.57143,4,"Flemington Racecourse",21,100.0,42,0,21,14,21,85.71429,100.0,4,42,100.0,100.0,12,92.85714,12,0,4,3,5,21,39,0.0,3,0,0.0,"206041120",100.0,5
957,1925,1604,634,812,81.818184,81.074165,204,"Lindisfarne - Rose Bay",1575,71.99582,5925,87,3188,782,2737,78.28209,66.77419,350,3974,75.55817,88.53591,724,79.994965,641,74,689,207,643,2049,3179,6.4969273,310,1139,10.714286,"601021008",58.285713,851
747,1872,1381,599,434,73.13034,76.30573,182,"New Town",1369,70.8166,4789,57,2483,785,2306,73.340416,61.53846,384,3755,71.939476,79.763466,761,73.23569,607,37,529,216,523,1883,2750,6.1666665,351,600,13.13364,"601051030",47.395832,727
1800,4069,2805,1101,1143,73.80192,65.96764,463,"Lavington",3003,62.27778,10989,151,5777,1669,5212,64.7806,57.142857,822,8399,67.82028,79.5,1600,69.15109,1272,91,1121,492,1117,4330,5808,6.2888737,861,1447,13.210849,"109011176",56.326035,1647
398,815,586,182,271,89.44785,70.81712,110,"Hay",729,71.35678,2152,76,1066,257,1086,73.71069,59.285713,161,1610,83.37469,82.47012,251,81.67702,207,37,284,83,336,795,1315,13.653136,140,271,28.044281,"109021177",68.32298,403
751,1593,1137,394,561,77.338356,69.244286,140,"Wentworth - Buronga",1232,67.909454,4313,115,2159,569,2154,70.62112,56.551723,286,3203,70.25641,81.404175,527,73.961914,429,69,510,164,548,1610,2369,12.568306,290,549,20.49911,"109021178",48.95105,780
457,1049,683,253,270,87.32126,71.875,128,"Wentworth-Balranald Region",916,69.80306,2517,73,1198,352,1319,71.81914,50.0,193,2000,80.620155,87.94118,340,79.95,299,40,319,71,416,951,1599,16.194332,142,247,27.037037,"109021179",66.32124,516
741,1412,1026,329,646,83.64023,73.111115,182,"Corowa",1181,65.04723,4204,91,2146,450,2058,70.95435,65.09804,286,2858,75.976845,88.045975,435,77.22183,383,49,482,166,525,1446,2207,7.0,255,700,14.086687,"109031180",63.636364,691
2044,5510,3968,1733,1169,82.28675,73.807495,734,"Griffith (NSW)",4534,70.450096,13609,239,6930,2348,6679,73.15634,61.627907,1122,10934,77.51595,84.30455,2351,77.757454,1982,159,1440,636,1579,5424,8502,10.557769,1032,1506,20.444824,"113011256",65.41889,2037
2922,6255,4953,1617,1734,89.70424,77.47964,882,"Dural - Kenthurst - Wisemans Ferry",5611,73.13484,16158,559,8169,2087,7989,77.963165,64.36012,1507,12608,85.053,91.91866,1918,83.78807,1763,334,2137,865,2407,6353,10564,18.39207,1344,1816,32.237602,"115021297",58.526875,2830
0,4,4,4,0,100.0,100.0,0,"Wilsons Promontory",4,0.0,8,0,4,4,4,100.0,0.0,0,8,0.0,100.0,4,100.0,4,0,0,0,0,4,8,0.0,0,0,0.0,"205031092",0.0,0
3511,9005,6120,2674,1638,77.0794,70.16531,838,"Epping - North Epping",6941,66.4483,21721,314,11078,3811,10643,66.594124,47.751606,2084,18195,81.56597,85.477295,3677,71.783455,3143,221,2333,892,2646,9190,13061,11.705508,1868,1888,19.16972,"126011495",40.211132,3244
866,2187,1587,691,577,78.5551,69.72755,248,"Moree",1718,68.47575,5664,140,2900,991,2764,70.00441,52.92683,427,4454,72.52986,78.90346,839,74.202965,662,86,593,217,668,2267,3305,13.586098,410,633,24.263432,"110031195",58.079624,921
641,1612,1072,400,321,88.46154,69.93007,168,"Moree Region",1426,75.35101,3680,146,1747,572,1933,71.898056,39.92806,298,3103,83.47222,86.02694,594,80.50274,511,78,483,111,601,1491,2498,30.46875,278,256,45.482864,"110031196",56.37584,720
834,1987,1489,626,501,83.643684,76.155716,260,"Narrabri",1662,70.26379,5076,105,2588,822,2488,73.74938,59.779613,391,4006,77.73852,85.27443,747,78.65701,637,60,586,217,660,2019,3151,10.544815,363,569,20.958084,"110031197",66.49616,849
586,1337,903,339,356,88.107704,69.18367,105,"Narrabri Region",1178,67.2355,3279,151,1586,490,1693,71.7806,49.45055,209,2595,78.84322,85.77495,471,80.19268,404,80,394,90,518,1258,2081,24.390244,182,328,42.41573,"110031198",50.239235,657
1163,2808,1946,718,754,82.30057,71.656685,349,"Leeton",2311,72.82889,7272,139,3710,1002,3562,68.76325,44.51128,643,5638,81.940926,86.938774,980,75.5055,852,85,847,296,971,2830,4257,9.659091,665,880,18.435013,"113011258",54.27683,1185
724,1583,1125,405,558,80.66962,70.8042,157,"Narrandera",1277,70.16575,4322,126,2181,572,2141,71.97697,51.685394,306,3146,74.53581,82.60038,523,76.35092,432,74,508,138,562,1563,2402,11.97411,267,618,22.580645,"113011259",51.30719,754
844,1748,1248,468,443,82.55149,73.35423,201,"Bacchus Marsh Region",1443,68.009476,4409,92,2218,638,2191,71.03017,54.18182,315,3505,77.496994,84.053154,602,76.77603,506,57,574,149,644,1757,2691,12.364425,275,461,20.767494,"201021009",63.809525,831
880,1857,1202,471,560,67.743675,64.87603,173,"New Norfolk",1258,57.159092,5020,60,2603,726,2417,61.546337,53.31412,351,3810,62.39316,74.81805,687,64.56693,514,43,503,185,511,1953,2460,6.6153846,347,650,10.714286,"601031020",49.28775,819
1387,3647,2555,969,1050,74.19797,67.62038,441,"Sandy Bay",2706,72.24225,9746,234,5049,1433,4697,68.02449,47.649574,990,7403,80.38431,72.94034,1408,71.06578,1027,138,1002,446,1004,3756,5261,10.672853,936,1293,22.285715,"601051031",44.545456,1249
996,2499,1812,780,720,83.07323,72.35622,304,"Gunnedah",2076,67.46988,6680,109,3461,1078,3219,70.83659,59.917355,471,5057,76.93857,86.8599,1035,76.88353,899,70,672,290,764,2558,3888,7.751938,484,903,15.138889,"110041199",64.543526,993
539,1248,803,273,348,88.86218,69.11392,148,"Gunnedah Region",1109,69.94434,3026,120,1430,395,1596,72.21223,49.4382,246,2360,80.29801,89.447235,398,81.01695,356,65,377,88,485,1112,1912,20.440252,178,318,34.482758,"110041200",60.1626,604
972,2079,1368,473,750,79.02838,63.404827,161,"Quirindi",1643,65.9465,5662,176,2833,746,2829,66.536964,43.195267,360,4135,71.4,82.33658,719,72.81741,592,108,641,146,714,2056,3011,13.899614,338,777,23.466667,"110041201",44.72222,1000
2518,5811,4375,1758,1514,81.448975,74.55471,778,"Tamworth - East",4733,70.135025,15154,257,7829,2358,7325,72.97748,60.142986,1286,11806,77.304344,86.29214,2225,77.14722,1920,178,1766,673,1778,5995,9108,9.705562,1119,1834,16.974901,"110041202",60.497665,2300
1733,4126,3309,1427,1112,80.85313,77.42811,501,"Tamworth - North",3336,69.82112,11303,184,6065,1843,5238,73.89459,60.97561,814,8604,75.47893,84.13516,1746,77.23152,1469,122,1210,550,1182,4478,6645,7.6874604,902,1587,16.546762,"110041203",61.547913,1566
580,1504,905,430,223,69.481384,61.870502,191,"Tamworth - West",1045,56.724136,3612,29,1885,695,1727,56.421448,38.29787,373,3108,66.32231,77.89799,647,62.741314,504,20,329,126,321,1604,1950,7.117438,329,281,13.004484,"110041204",51.206436,484
2558,4953,3949,1449,1705,86.129616,77.40385,496,"Tamworth Region",4266,70.40657,13584,423,6926,1872,6658,75.24771,53.056236,827,10201,76.43655,87.756294,1707,80.53132,1498,265,1801,434,1849,5248,8215,15.79261,818,1678,24.809383,"110041205",59.975815,2419
2353,5135,3721,1452,1564,76.65044,76.82539,643,"Belmont - Bennetts Green",3936,64.38589,13786,149,7087,1890,6699,70.64743,63.378906,1103,10402,71.62896,85.67508,1822,73.61085,1561,105,1515,649,1583,5267,7657,5.769231,1024,1820,9.5268545,"111011206",58.29556,2210
850,1636,1098,416,585,70.293396,75.77413,180,"Belmont South - Blacksmiths",1150,57.764706,4548,49,2327,549,2221,63.911526,52.664577,333,3354,65.239296,79.17485,509,67.02445,403,23,491,168,518,1718,2248,3.776683,319,609,8.376068,"111011207",54.054054,794
2881,7099,5478,2558,1761,78.518105,80.238396,761,"Charlestown - Dudley",5574,67.85838,18515,184,9655,3188,8860,74.03703,62.030075,1327,14498,72.72075,87.17348,2986,76.2312,2603,140,1955,825,2026,7399,11052,6.2056737,1330,2256,10.448608,"111011208",57.3474,2786
2073,4074,3119,1057,905,83.627884,77.77778,489,"West Pennant Hills",3407,67.29378,10211,259,5232,1359,4979,71.98246,58.712543,957,8407,81.97449,89.878235,1314,77.625786,1181,138,1395,529,1478,4333,6526,15.350389,901,899,28.618784,"115011296",51.09718,1803
530,1346,748,238,329,59.286777,80.13468,94,"Little Grove - Elleker",798,71.320755,2919,69,1244,297,1675,78.902954,71.900826,239,2294,71.53025,42.752293,545,67.393196,233,45,378,87,402,948,1546,15.202703,121,296,20.972645,"509011232",39.330544,562
768,1894,1457,649,376,75.55438,80.62112,160,"South Hobart - Fern Tree",1431,71.484375,4766,77,2496,805,2270,73.58586,49.63145,385,3874,77.29196,80.75,800,74.54827,646,57,549,202,548,1980,2888,11.046512,407,516,20.478724,"601051032",41.55844,709
2948,7115,5312,2380,1653,78.58047,77.77778,792,"Glendale - Cardiff - Hillsborough",5591,67.808685,18099,190,9331,3060,8768,72.70737,62.326656,1423,14421,74.07274,87.54717,2915,75.60502,2552,124,1999,809,2057,7306,10903,6.123457,1298,2025,11.494253,"111011209",55.657063,2777
997,1788,1289,453,1216,71.47651,66.617645,207,"Tweed Heads South",1278,59.578735,6584,81,3580,680,3004,64.22521,53.636364,359,3795,60.47088,80.7074,622,67.64163,502,65,594,177,488,2007,2567,4.132231,330,1573,6.6611843,"112031552",57.660168,807
649,1386,1112,439,326,80.23088,80.10949,170,"Trevallyn",1112,72.72727,3525,51,1813,548,1712,75.85266,59.8513,292,2852,78.41106,84.85437,515,77.98036,437,40,472,161,454,1466,2224,11.527377,269,347,15.644172,"602011049",58.219177,579
1139,2465,1568,643,659,67.70791,63.66337,284,"Mount Hutton - Windale",1669,55.575066,6702,54,3578,1010,3124,59.013924,52.755905,530,5122,62.463055,75.76087,920,63.19797,697,24,633,268,634,2657,3237,2.605863,508,921,8.194234,"111011210",53.584908,1015
485,997,717,248,316,80.14042,77.01863,132,"Redhead",799,67.83505,2688,34,1375,322,1313,73.387924,68.82353,199,1974,72.85714,89.61039,308,76.79838,276,23,329,117,357,977,1516,5.7788944,170,398,10.759494,"111011211",66.33166,490
1643,3218,2199,793,1276,75.046616,74.320526,371,"Swansea - Caves Beach",2415,61.53378,9245,104,4751,1067,4494,67.5576,60.91743,626,6473,67.87565,85.1145,1048,71.2807,892,63,1011,332,1048,3255,4614,4.21123,545,1496,8.15047,"111011212",59.265175,1544
1814,3407,2792,962,1122,83.06428,80.56951,434,"Valentine - Eleebana",2830,71.3892,9434,149,4905,1194,4529,76.367615,67.74691,717,7063,79.18689,90.40307,1042,79.59791,942,96,1295,439,1305,3656,5622,7.686149,648,1249,13.279858,"111011213",60.529987,1648
1839,3836,2988,1155,1186,81.100105,78.35821,521,"Warners Bay - Boolaroo",3111,67.59108,10605,154,5583,1474,5022,73.75957,63.68564,814,7887,74.800735,87.41912,1391,77.32978,1216,120,1243,470,1220,4051,6099,7.832898,738,1532,12.984823,"111011214",64.00491,1631
1161,2437,1611,594,715,70.16824,65.92675,291,"Bolton Point - Teralba",1710,62.704563,6561,71,3409,901,3152,63.475178,51.05042,567,4975,65.86769,79.92745,827,66.75377,661,46,728,243,687,2538,3321,5.281286,476,871,9.93007,"111021215",51.32275,1043
1178,2386,1770,691,888,76.48785,74.541534,266,"Bonnells Bay - Silverwater",1825,61.629883,6802,106,3528,927,3274,68.55151,57.232704,482,4968,68.81721,85.01703,881,72.36312,749,80,726,273,704,2582,3595,8.456659,477,946,11.936937,"111021216",55.18672,1023
768,1662,1362,513,257,84.47653,77.375565,197,"Castle Hill - West",1404,74.08854,4025,64,2106,663,1919,74.67105,58.524174,371,3486,87.01657,90.47619,567,79.345955,513,50,569,230,630,1824,2766,17.730497,393,282,24.902723,"115011557",53.09973,724
1504,4228,3268,1697,728,81.433304,78.82025,513,"Edgeworth - Cameron Park",3443,66.555855,10348,56,5392,2153,4956,73.10962,64.08364,831,8698,77.10844,89.929504,1986,77.15567,1786,49,1001,521,1088,4470,6711,5.3145337,813,922,7.6923075,"111021217",61.732853,1411
1843,4086,2699,982,1639,72.46696,69.10626,432,"Morisset - Cooranbong",2961,62.66956,11879,170,6154,1421,5725,65.414444,51.62413,885,8212,68.42394,80.652176,1380,68.92352,1113,117,1155,445,1246,4126,5660,5.769231,862,2028,10.372178,"111021218",48.81356,1821
1821,3674,2585,947,1420,73.70713,70.51378,409,"Toronto - Awaba",2708,60.40637,10629,172,5535,1343,5094,66.69247,58.567417,755,7550,67.84643,79.55272,1252,70.10596,996,121,1100,417,1131,3876,5293,7.2935505,712,1659,12.112676,"111021219",54.172184,1667
1301,2538,1819,701,1031,76.516945,76.77985,252,"Wangi Wangi - Rathmines",1942,61.106842,7170,109,3601,913,3569,69.666794,60.95718,478,5149,71.14309,85.41409,809,73.04331,691,81,795,242,890,2611,3761,8.181818,397,990,10.57226,"111021220",52.719666,1251
860,2065,1407,634,417,77.72397,74.76415,235,"West Wallsend - Barnsley - Killingworth",1605,59.65116,4971,43,2489,848,2482,67.19198,61.9171,413,4159,73.77049,87.34336,798,72.42126,697,21,513,239,630,2094,3012,5.316456,386,395,10.31175,"111021221",56.900726,854
1589,3884,2751,1020,872,89.44387,75.72383,466,"Griffith Region",3474,74.764,9120,325,4364,1347,4756,76.75781,58.024693,752,7468,83.41014,88.46705,1396,83.35565,1235,167,1188,376,1448,3584,6225,21.410257,648,780,37.27064,"113011257",61.968086,1736
1882,4707,3754,1715,1159,81.87805,81.27962,564,"Adamstown - Kotara",3854,71.14771,12136,127,6270,2110,5866,76.80033,68.75,962,9595,77.948715,90.201004,1990,79.2913,1795,84,1339,616,1368,4888,7608,6.0781474,896,1382,10.957722,"111031222",58.627857,1755
1022,2404,1481,636,705,71.08985,64.43769,252,"Beresfield - Hexham",1709,54.01174,6416,51,3307,987,3109,59.430176,51.966873,484,4896,67.918785,78.82353,935,65.15523,737,42,552,251,669,2492,3190,5.153374,483,815,7.2340426,"111031223",52.066116,985
441,1069,623,202,365,77.17493,68.70748,95,"Tumbarumba",825,66.666664,2649,107,1215,294,1434,71.03763,47.887325,157,1946,71.62427,64.089775,401,74.40904,257,59,294,68,366,877,1448,17.455622,142,338,29.31507,"113021260",60.509556,511
749,1637,1152,449,543,81.12401,70.59748,173,"Tumut",1328,65.15354,4508,85,2328,636,2180,67.526375,53.89408,317,3343,77.76183,84.751205,623,74.18486,528,42,488,173,542,1706,2480,6.7524114,321,622,15.653775,"113021261",54.57413,697
644,1344,941,338,480,85.04464,75.2784,119,"Tumut Region",1143,67.85714,3571,133,1747,449,1824,73.803925,48.35165,221,2619,76.45349,83.90804,435,79.57236,365,78,437,88,526,1275,2084,16.525423,182,472,27.708334,"113021262",53.846153,688
980,1924,1343,485,887,76.14345,69.28571,186,"Cootamundra",1465,63.061226,5833,136,3022,700,2811,67.35206,54.4586,342,3918,67.46611,79.61477,623,71.66922,496,69,618,171,647,1994,2808,6.7120624,314,1028,15.332582,"113031263",54.385963,959
436,982,717,262,327,87.9837,76.608185,136,"Gundagai",864,66.51376,2631,89,1322,342,1309,74.60978,63.387978,203,1943,78.63436,86.76923,325,81.36902,282,49,290,116,357,961,1581,13.573407,183,361,27.217125,"113031264",66.99507,454
683,2325,1067,407,434,52.946236,74.54212,173,"Junee",1231,67.64275,4716,99,1957,546,2759,71.03861,49.084248,403,3827,59.069767,42.467045,1062,60.047035,451,64,462,134,508,1502,2298,14.065934,273,455,22.81106,"113031265",42.92804,860
884,1782,1263,444,710,81.818184,73.26733,192,"Temora",1458,67.08145,5070,141,2578,606,2492,70.519264,49.169434,344,3573,74.48037,83.916084,572,76.154495,480,78,593,148,645,1791,2721,9.911055,301,787,19.859156,"113031266",55.813953,866
2055,4769,3845,1596,1244,85.09122,78.69823,670,"Wagga Wagga - East",4058,72.65207,12465,229,6452,2028,6013,76.73119,64.22414,1042,9780,80.82847,88.77441,1844,80.80777,1637,160,1493,596,1522,5011,7903,11.1034,928,1441,18.40836,"113031267",64.29942,1883
378,1318,1157,458,213,79.438545,80.49209,220,"Wagga Wagga - North",1047,80.42328,3387,26,1856,569,1531,72.904854,58.4375,403,2905,86.90808,87.94964,556,75.869194,489,21,304,374,312,1587,2204,7.8066916,640,269,12.206573,"113031268",54.590572,359
1124,2034,1232,357,736,69.86234,59.59933,169,"Kyogle",1421,59.25267,5543,151,2773,599,2770,61.080814,43.877552,341,4051,61.859253,71.77122,542,65.490005,389,80,666,129,712,2017,2653,10.58201,294,756,20.516304,"112021247",49.560116,1151
1973,4501,3039,1139,1026,66.60742,66.64716,474,"Lismore",2998,63.6594,11573,136,6046,1709,5527,65.28464,53.545734,956,9156,61.26543,74.76577,1601,65.934906,1197,123,1256,521,1191,4655,6037,8.842559,973,1391,13.255361,"112021248",49.58159,1944
1464,3809,2819,1183,802,74.954056,78.44827,466,"Hamilton - Broadmeadow",2855,66.25683,9383,111,4772,1508,4611,74.379944,70.782394,768,7599,67.27989,82.55431,1519,74.66772,1254,87,970,579,1024,3790,5674,8.85947,818,982,13.840399,"111031224",60.677082,1522
1299,3840,2732,1234,699,71.302086,75.47401,486,"Waratah - North Lambton",2738,65.43495,9278,59,4739,1635,4539,70.15922,61.354168,912,7734,65.70946,81.13532,1744,70.72666,1415,59,850,589,778,3894,5470,6.9822483,960,845,8.440629,"111031234",53.289474,1184
2239,4950,4084,1749,1088,79.030304,80.82255,577,"Lambton - New Lambton",3912,72.443054,12762,156,6724,2164,6038,76.39356,64.156944,1025,10296,75.32403,86.92027,1919,77.661224,1668,108,1622,605,1511,5346,7996,7.8374457,943,1378,14.338235,"111031225",56.292683,2006
1610,4323,3243,1602,569,79.875084,79.07206,549,"Maryland - Fletcher - Minmi",3453,65.96273,9979,81,5087,2026,4892,71.9707,61.83908,980,8829,79.28339,88.82743,1808,75.84098,1606,41,1062,538,1217,4506,6696,7.0567985,870,581,14.235501,"111031226",56.02041,1535
1813,3480,2729,1120,1224,79.02299,78.43137,340,"Kingscliff - Fingal Head",2750,64.97518,9800,155,5096,1428,4704,71.9673,61.5245,607,7272,70.828186,88.36653,1255,75.34379,1109,92,1178,339,1146,3792,5479,7.055215,551,1304,12.663399,"112031250",56.01318,1618
1201,2315,1591,595,813,71.66307,66.33222,215,"Murwillumbah",1659,60.11657,6638,88,3510,897,3128,62.885376,49.537037,438,4845,65.7277,80.78818,812,67.07946,656,60,722,214,700,2530,3250,6.122449,432,980,10.824108,"112031251",49.086758,1065
1571,2806,1859,576,857,73.77049,66.976746,219,"Murwillumbah Region",2070,62.25334,7152,203,3489,860,3663,65.66584,49.5,432,5637,65.45106,77.06535,811,69.700195,625,107,978,198,1023,2831,3929,16.261398,400,658,23.68728,"112031252",50.694443,1563
1838,3587,2684,1062,1079,78.031784,71.467026,353,"Pottsville",2799,66.53972,9613,120,4947,1486,4666,69.533676,57.649254,593,7447,70.95238,86.30137,1314,73.62696,1134,90,1223,309,1192,3860,5483,8.279669,536,1087,11.121408,"112031253",59.527824,1680
2603,4919,3593,1313,2371,74.77129,69.69215,489,"Tweed Heads",3678,61.237034,15317,244,8027,1884,7290,67.3477,60.96698,860,10254,65.40962,81.96347,1752,70.90891,1436,169,1594,517,1509,5335,7271,6.27786,848,2692,10.291017,"112031254",56.860466,2307
2123,3789,3204,1141,1954,79.836365,75.864365,505,"Banora Point",3025,66.32124,12536,181,6793,1504,5743,72.818184,65.976715,807,8189,73.50061,84.421364,1348,76.06545,1138,145,1408,510,1201,4400,6229,6.0593395,773,2393,9.26305,"112031550",62.577446,1634
469,962,763,261,247,81.08108,76.99115,123,"Terranora - North Tumblegum",780,71.42857,2455,42,1246,339,1209,75.17242,66.18358,212,1977,78.77462,87.030716,293,78.04755,255,30,335,137,360,1015,1543,12.987013,207,231,17.00405,"112031551",58.018867,457
1764,4911,3472,1699,844,70.69843,75.34368,532,"Mayfield - Warabrook",3472,63.94558,11743,93,5988,2255,5755,70.21233,61.339092,966,9856,62.342857,80.0,2195,70.454544,1756,77,1128,568,1091,4945,6944,7.3825502,926,1043,11.018957,"111031227",55.072464,1750
1759,4389,3509,1523,876,84.02825,85.513756,562,"Merewether - The Junction",3688,71.51791,10703,151,5438,1781,5265,79.62333,71.97232,855,8796,76.84757,91.231964,1802,81.82128,1644,104,1258,624,1331,4407,7197,10.087294,867,1031,17.237442,"111031228",65.730995,1732
1293,3817,2870,1357,636,81.53,82.242424,461,"Newcastle - Cooks Hill",3112,67.285385,8902,164,4449,1650,4453,78.01033,71.195656,685,7496,71.63833,84.87486,1838,79.80256,1560,119,870,524,927,3679,5982,15.454545,736,770,25.786163,"111031229",67.29927,1294
0,0,0,0,3,0.0,0.0,0,"Newcastle Port - Kooragang",0,0.0,3,0,0,0,3,0.0,0.0,0,0,0.0,0.0,0,0.0,0,0,0,0,0,0,0,0.0,0,0,0.0,"111031230",0.0,0
772,4148,2012,753,573,53.109932,55.943535,621,"Shortland - Jesmond",2203,58.937824,9371,32,4650,1346,4721,51.655968,43.894203,1731,8043,60.583015,65.847664,1628,52.40582,1072,24,455,780,478,3895,4215,3.178808,1777,755,5.5846424,"111031231",35.875217,789
966,1888,1312,524,871,75.21186,75.504326,158,"Stockton - Fullerton Cove",1420,59.420288,5602,85,2843,694,2759,68.29776,60.91954,287,3809,64.653244,84.72419,707,71.72486,599,55,574,159,578,1921,2732,5.965293,261,922,9.758898,"111031232",55.052265,894
2473,4438,3362,1027,1201,77.46733,70.29432,368,"Lismore Region",3438,70.96644,11281,363,5642,1461,5639,72.8494,54.919235,731,9053,70.268105,78.72517,1208,75.11322,951,206,1755,374,1756,4615,6800,20.058422,681,1027,30.224813,"112021249",50.342,2499
384,1211,915,473,194,76.87862,81.13207,138,"Downer",931,69.53125,2870,29,1465,583,1405,75.99668,63.291138,265,2415,72.703415,86.19469,565,76.43893,487,25,267,150,277,1204,1846,9.578544,237,261,14.948454,"801051055",52.07547,381
931,2224,1560,692,565,73.741005,73.460724,268,"Claremont (Tas.)",1640,62.083782,5889,51,3100,942,2789,67.91467,57.78302,484,4521,71.13636,80.81396,860,70.7808,695,45,578,245,626,2297,3200,5.603985,424,803,9.026548,"601031015",55.371902,880
485,1305,814,381,277,71.264366,70.42514,117,"Derwent Park - Lutana",930,61.85567,3126,33,1544,541,1582,65.857605,52.38095,227,2541,69.216064,75.315315,555,68.6344,418,23,300,110,362,1236,1744,7.4675326,210,308,11.913358,"601031016",51.54185,523
2392,5703,4017,1768,1590,73.78573,72.37003,654,"Wallsend - Elermore Vale",4208,61.95652,15345,166,8052,2443,7293,67.2639,58.223396,1248,11675,70.3281,81.16496,2352,70.44968,1909,105,1482,662,1479,5972,8225,5.048077,1137,2080,10.440251,"111031233",52.403847,2103
724,1480,1212,385,496,90.60811,75.638504,200,"Galston - Laughtondale",1341,77.48619,4051,127,2075,509,1976,78.85491,58.223682,321,3017,85.12748,91.169975,453,84.62048,413,89,561,177,601,1537,2553,16.542751,304,538,25.60484,"115021298",62.305298,706
353,737,564,181,259,88.60244,72.11156,64,"Bilpin - Colo - St Albans",653,72.804535,1933,67,937,251,996,77.04918,61.71875,116,1469,80.84577,89.95434,219,82.845474,197,47,257,79,325,732,1217,22.926828,128,205,25.868727,"115031299",55.172413,402
3036,6844,5340,1973,1341,88.74927,81.56263,999,"Kurrajong Heights - Ebenezer",6074,74.76943,16375,346,8190,2419,8185,78.11586,64.59087,1473,13680,85.04457,91.92998,2342,83.43567,2153,205,2270,892,2576,6836,11414,15.140325,1381,1354,25.801641,"115031300",67.82077,3029
1307,3271,2560,1099,645,90.03363,83.00604,457,"Pitt Town - McGraths Hill",2945,73.45065,7845,146,3929,1324,3916,78.52761,65.659775,663,6531,86.16541,93.583725,1278,84.290306,1196,88,960,413,1146,3260,5505,13.153961,629,669,22.635658,"115041301",68.92911,1330
2588,7188,5565,2630,811,87.423485,79.4802,936,"Rouse Hill - Beaumont Hills",6284,72.17929,16266,227,8267,3309,7999,75.27391,62.09893,1600,14581,89.10551,93.876175,2972,81.26329,2790,138,1868,929,2331,7393,11849,15.789474,1496,874,27.990135,"115041302",58.5,2616
1247,2708,2025,778,888,83.493355,75.53398,344,"Moss Vale - Berrima",2261,67.28148,7491,179,3895,1030,3596,72.894165,60.07984,600,5486,76.39594,90.17278,926,78.12614,835,107,839,301,903,2778,4286,9.57923,501,1117,20.157658,"114021287",57.333332,1182
916,2760,2141,1158,400,75.72464,82.95129,271,"Wickham - Carrington - Tighes Hill",2090,67.90393,6367,42,3207,1396,3160,77.656876,68.98876,457,5517,67.051414,84.296295,1350,76.69023,1138,54,622,307,639,2757,4231,12.0,445,450,10.5,"111031235",59.29978,953
2316,4193,3165,1107,2098,75.91223,72.258484,392,"Ballina",3183,64.11917,13392,248,7101,1532,6291,70.270874,63.719513,705,8697,67.77996,80.09642,1452,72.990685,1163,155,1485,418,1380,4504,6348,5.9684253,656,2597,11.820782,"112011236",55.602837,2036
2462,4441,3588,1186,1659,83.13443,74.17136,407,"Ballina Region",3692,70.755486,12793,339,6693,1599,6100,73.94889,57.774967,788,9293,76.507935,86.94752,1448,78.33853,1259,203,1742,457,1687,4852,7280,11.026616,791,1841,20.433996,"112011237",51.649746,2205
886,1616,1268,486,376,81.86881,77.63578,111,"Bangalow",1323,68.623024,4089,113,2097,626,1992,74.195435,56.85279,215,3325,74.61988,84.432236,546,77.92481,461,62,608,112,638,1709,2591,15.979382,197,388,30.053192,"112011238",51.627907,855
1307,2252,1748,659,622,75.17762,69.00523,180,"Brunswick Heads - Ocean Shores",1693,65.57001,6188,106,3314,955,2874,67.282524,47.916668,373,4850,69.16221,83.35535,757,70.948456,631,71,857,161,776,2598,3441,9.916202,336,716,17.041801,"112011239",48.257374,1122
1261,2651,2190,1038,601,79.85666,80.40279,206,"Byron Bay",2117,65.74148,6840,123,3588,1291,3252,74.38859,64.79592,348,5595,70.86957,84.38855,1153,76.97945,973,69,829,254,815,2944,4307,10.714286,392,644,20.46589,"112011240",59.195404,1150
683,1424,930,332,619,71.34831,73.61419,129,"Evans Head",1016,61.054173,3988,87,1945,451,2043,68.68538,57.272728,229,2778,61.48649,75.82417,455,70.0504,345,55,417,126,455,1354,1946,9.30626,220,591,14.054927,"112011241",56.33188,740
1238,2202,1933,732,580,84.19618,80.17525,234,"Lennox Head - Skennars Head",1854,71.970924,5906,117,3124,913,2782,76.797775,63.934425,393,4719,77.083336,91.50066,753,80.25005,689,76,891,234,814,2517,3787,12.520593,366,607,20.172413,"112011242",59.541985,1056
1279,2117,1585,538,601,73.689186,68.36086,147,"Mullumbimby",1560,65.20719,5696,139,2978,787,2718,67.38946,45.104897,301,4469,66.37931,76.82927,656,70.37369,504,84,834,129,770,2352,3145,13.41853,286,626,23.12812,"112011243",48.837208,1160
1423,3131,2022,746,1139,69.754074,61.85738,371,"Casino",2184,58.608574,9023,121,4753,1206,4270,60.629684,49.858356,693,6466,62.703102,77.767525,1084,65.04794,843,90,834,352,849,3335,4206,6.3469677,706,1418,10.623354,"112021244",53.535355,1354
1011,1979,1224,355,672,73.875694,61.206898,177,"Casino Region",1462,60.83086,5160,164,2509,580,2651,63.28852,46.355686,361,3913,65.9434,75.62724,558,68.64298,422,95,615,159,699,1934,2686,16.52174,343,575,24.404762,"112021245",49.03047,1060
1677,3460,2792,1100,1070,77.57226,73.52941,405,"Goonellabah",2684,68.09779,9897,153,5367,1496,4530,70.93496,57.27392,726,7396,74.04745,81.60834,1343,74.04002,1096,113,1142,437,1030,3936,5476,7.896576,763,1431,14.299066,"112021246",55.785126,1391
2542,6215,4924,2074,1202,80.96541,75.36337,844,"Wagga Wagga - South",5032,71.8332,15742,187,8325,2752,7417,73.24111,62.421272,1409,12938,78.998245,87.075096,2530,76.951614,2203,132,1826,892,1798,6723,9956,8.2397,1429,1602,15.557405,"113031269",59.90064,2276
1279,3710,2668,1128,771,79.38005,72.63361,628,"Wagga Wagga - West",2945,64.5817,9330,132,4849,1553,4481,70.61938,64.37632,958,7488,74.04903,83.42893,1569,74.95994,1309,105,826,609,876,3778,5613,9.803922,946,1071,17.120623,"113031270",65.55324,1183
1782,4276,3173,1187,1143,88.7044,76.72916,572,"Wagga Wagga Region",3793,73.56902,10603,374,5184,1547,5419,77.20195,56.850193,921,8386,80.79827,89.87342,1501,83.06702,1349,231,1311,444,1498,4110,6966,21.508379,781,1074,32.72091,"113031271",62.106407,1854
1243,2086,1671,532,1270,85.57047,77.66423,216,"Berry - Kangaroo Valley",1785,65.96943,6967,198,3611,685,3356,75.50836,63.157894,321,4299,70.42002,90.24768,646,80.390785,583,139,820,180,788,2213,3456,9.942776,285,1398,15.590551,"114011272",67.28972,1119
552,944,611,190,487,68.11441,66.901405,110,"Callala Bay - Currarong",643,53.985508,2878,29,1447,284,1431,60.978043,56.626507,202,1946,63.346615,77.5,240,64.43988,186,29,298,94,318,1002,1254,6.516854,166,445,5.9548254,"114011273",54.455444,502
672,1290,811,270,715,71.78294,69.58763,118,"Culburra Beach",926,61.607143,3970,55,1965,388,2005,65.297905,53.846153,203,2532,62.028984,81.86398,397,68.6019,325,29,414,98,428,1242,1737,4.011065,182,723,7.6923075,"114011274",58.12808,690
3,22,0,0,6,72.72727,0.0,0,"Ettrema - Sassafras - Budawang",16,0.0,31,0,3,0,28,0.0,0.0,0,25,64.70588,100.0,5,64.0,5,0,0,0,11,3,16,0.0,0,0,0.0,"114011275",0.0,17
624,1080,825,315,532,78.51852,74.82185,84,"Huskisson - Vincentia",848,60.25641,3403,58,1791,421,1612,69.095474,63.75839,152,2274,68.81721,87.02702,370,73.5708,322,39,376,95,384,1194,1673,6.5326633,149,597,10.902256,"114011276",55.263157,558
2162,4294,3123,1158,1488,77.2939,71.65842,521,"North Nowra - Bomaderry",3319,62.53469,11980,189,6198,1616,5782,67.97997,61.27451,866,8888,70.7124,82.77886,1533,72.47975,1269,113,1352,500,1340,4594,6442,7.0448875,816,1604,12.701612,"114011277",60.161663,1895
2169,5917,3423,1465,1469,63.106304,65.754036,662,"Nowra",3734,54.81789,14588,139,7202,2228,7386,61.631256,57.13051,1288,11471,58.84561,67.21377,2498,62.39212,1679,108,1189,661,1254,5554,7157,6.553398,1157,1648,9.462219,"114011278",51.397514,2131
1827,3417,2191,814,1760,67.13491,64.297,350,"St Georges Basin - Erowal Bay",2294,53.366173,10837,101,5660,1266,5177,58.598557,50.92879,649,7156,58.93186,77.52415,1139,62.67468,883,73,975,329,960,3739,4485,3.8001041,646,1921,5.7386365,"114011279",53.929123,1629
608,1002,578,181,786,64.67066,68.30189,85,"Sussex Inlet - Berrara",648,48.355263,3628,42,1840,265,1788,57.34127,45.185184,133,2010,53.34477,73.426575,286,60.995026,210,42,294,61,311,1008,1226,5.048077,135,832,5.3435116,"114011280",63.909775,583
543,1009,756,239,335,82.6561,76.35783,107,"Tomerong - Wandandian - Woollamia",834,68.69245,2657,66,1313,313,1344,72.9026,55.24862,174,2046,73.55679,89.26174,298,77.71261,266,44,373,100,395,1037,1590,15.942029,181,276,19.701492,"114011281",61.49425,537
2192,3683,2620,914,2018,73.689926,71.6301,347,"Ulladulla",2714,57.20803,11915,184,6214,1276,5701,65.09317,59.605026,604,7708,62.43386,84.356606,1189,69.20083,1003,120,1254,332,1180,4025,5334,5.481955,557,2189,9.117939,"114011282",57.450333,1890
810,1395,887,260,657,71.97133,73.23943,110,"Ulladulla Region",1004,58.39506,3994,94,1942,355,2052,66.892914,60.869564,177,2721,59.25926,81.355934,354,69.496506,288,56,473,98,512,1326,1891,9.090909,161,616,14.307458,"114011283",62.146893,864
1740,2735,2448,713,1912,91.70018,74.03946,298,"Bowral",2508,68.85058,10278,339,5631,963,4647,75.95408,57.692307,516,5958,81.02711,89.96328,817,83.182274,735,237,1198,300,1136,3223,4956,9.842193,520,2408,17.730125,"114021284",57.751938,1402
797,1844,1356,523,369,84.76139,72.638885,245,"Hill Top - Colo Vale",1563,69.63614,4452,76,2239,720,2213,71.974525,65.12261,381,3728,80.82368,89.50437,686,78.299355,614,39,555,239,628,1884,2919,10.985915,367,355,20.596207,"114021285",64.30446,777
1228,2282,1928,677,868,88.2121,79.274,267,"Mittagong",2013,70.68404,6828,181,3678,854,3150,72.59036,44.773518,409,4938,79.627815,88.26291,852,79.80964,752,126,868,257,813,2656,3941,12.328767,574,1022,20.852535,"114021286",65.28117,1021
2614,6888,5273,2584,1549,86.13531,75.489334,658,"Baulkham Hills (East)",5933,72.34124,17335,271,8898,3423,8437,74.92185,57.34266,1205,13926,82.61576,92.20739,3221,80.468185,2970,224,1891,574,2034,7038,11206,12.043011,1001,1860,17.495157,"115011290",54.60581,2462
2842,6398,5096,1944,1242,85.87058,78.48203,894,"Baulkham Hills (West) - Bella Vista",5494,72.765656,15753,316,8113,2477,7640,74.51382,58.68421,1542,13237,85.46555,91.50858,2214,80.00302,2026,192,2068,892,2258,6839,10590,15.070643,1520,1274,25.442835,"115011291",57.976654,2642
499,794,561,179,425,75.18892,73.36066,30,"Bruny Island - Kettering",597,65.33066,2365,66,1146,244,1219,69.68944,33.870968,96,1599,68.61167,79.60199,201,72.420265,160,35,326,21,341,805,1158,10.263929,62,341,15.529411,"603021069",31.25,497
690,1182,761,230,439,68.18951,60.686016,75,"Cygnet",806,59.565216,3255,75,1634,379,1621,62.22404,44.805195,195,2405,60.80645,76.0218,367,65.15592,279,51,411,69,377,1223,1567,12.408759,154,411,17.084282,"603021070",38.46154,620
902,1755,1397,425,610,90.59829,78.996284,282,"Glenhaven",1590,74.61198,4940,121,2575,538,2365,77.09713,62.634407,437,3567,89.0,91.698845,518,83.73984,475,66,673,233,712,1812,2987,8.650065,372,763,19.836065,"115011294",64.53089,800
932,2293,1825,831,506,87.13476,75.06775,219,"Castle Hill - Central",1998,71.35193,5854,130,3055,1107,2799,74.06656,57.17647,419,4757,82.1118,92.42283,1069,80.365776,988,86,665,243,661,2464,3823,14.551607,425,591,25.6917,"115011553",52.267303,805
1592,6930,6017,3948,914,88.32612,88.20375,595,"Prahran - Windsor",6121,70.85427,16230,193,8386,4476,7844,83.23419,70.88717,891,14159,76.57253,92.39009,4481,85.726395,4140,118,1128,823,1193,7229,12138,10.19879,1161,1157,21.115974,"206061136",66.7789,1558
549,1046,609,203,433,66.826004,64.64968,82,"Geeveston - Dover",699,54.462658,2862,57,1383,314,1479,59.647404,39.873417,172,2067,58.020477,76.388885,288,63.280117,220,44,299,63,340,1021,1308,12.154696,158,362,13.163972,"603021071",47.67442,586
1206,2454,1675,671,633,74.97962,73.25327,222,"Huonville - Franklin",1840,60.613598,6307,85,3220,916,3087,66.07495,51.33172,430,4989,68.449196,84.81153,902,70.455,765,61,731,212,768,2535,3515,8.905109,413,685,13.42812,"603021072",51.627907,1122
681,1379,1034,334,507,81.7984,75.90909,198,"Castle Hill - East",1128,69.01615,4162,45,2276,440,1886,70.773445,58.82353,369,2840,85.400314,91.42091,373,76.12676,341,30,470,200,544,1461,2162,3.6809816,340,815,8.87574,"115011554",53.658535,637
1723,3634,2770,971,905,86.68134,74.52034,438,"Castle Hill - North",3150,70.69066,9286,250,4747,1303,4539,73.435844,56.83646,812,7406,86.09694,88.67624,1254,79.93519,1112,157,1218,424,1350,3772,5920,16.102564,746,975,27.62431,"115011555",53.940887,1568
1377,3948,2426,1135,644,76.215805,65.267395,411,"Blacktown (South)",3009,59.622368,9221,83,4629,1739,4592,62.558018,54.855644,854,7826,74.02894,86.63672,1781,69.44799,1543,52,821,418,972,3878,5435,6.9241014,762,751,12.888199,"116011560",48.126465,1313
359,630,371,104,300,67.14286,64.596275,24,"Forestier - Tasman",423,57.103065,1779,57,849,161,930,63.96552,55.0,56,1210,52.07824,78.181816,165,65.619835,129,29,205,33,213,580,794,10.780669,60,269,19.0,"603031073",42.857143,409
1260,2836,2264,944,678,87.58815,75.219124,344,"Castle Hill - South",2484,68.09524,7315,178,3801,1255,3514,73.81806,62.31884,600,5903,83.65553,91.98543,1098,80.43368,1010,118,858,344,952,3067,4748,16.076294,552,734,26.253687,"115011556",57.333332,1138
611,3081,2277,1587,190,79.03278,80.72228,210,"Collingwood",2435,61.865795,6583,45,3312,1966,3271,74.411766,57.763977,391,6141,64.72262,86.81429,1987,76.73017,1725,33,378,279,455,3060,4712,13.095238,483,252,23.68421,"206071141",53.70844,703
670,1134,767,256,657,76.278656,74.202896,83,"Triabunna - Bicheno",865,58.80597,3500,97,1709,345,1791,69.28636,58.695652,137,2241,62.973763,81.35048,311,72.82463,253,63,394,54,432,1107,1632,10.465117,92,602,14.764079,"603031074",60.583942,686
2899,5996,4449,1534,1238,81.721146,76.204666,724,"Cherrybrook",4900,68.64436,14946,297,7712,2013,7234,71.4584,55.63166,1515,12222,83.376915,91.29712,1804,76.49321,1647,194,1990,731,2232,6226,9349,13.055182,1314,1486,23.990307,"115011558",47.78878,2677
2911,7396,5808,2586,1008,85.65441,78.26877,905,"Kellyville",6335,73.37685,17222,235,8818,3304,8404,75.07756,61.669952,1626,15132,87.184875,92.82773,2914,80.24716,2705,148,2136,938,2490,7736,12143,13.678373,1521,1082,23.313492,"115011559",55.65806,2856
1463,5683,3303,2003,752,79.623436,65.436134,493,"Blacktown (East) - Kings Park",4525,55.50239,12657,98,6222,3061,6435,61.669155,50.60096,947,11039,70.73826,88.72459,3246,70.912224,2880,67,812,421,1054,5356,7828,7.7367206,832,866,13.031915,"116011303",52.059135,1490
378,892,586,240,255,67.152466,64.17112,105,"Acton - Upper Burnie",599,58.73016,2449,20,1302,374,1147,60.662525,52.33645,202,1858,57.97546,78.2967,364,63.778255,285,12,222,112,189,966,1185,3.5714285,214,336,7.8431373,"604011075",51.980198,326
1957,5676,3541,1754,1032,77.51938,66.014305,638,"Blacktown (North) - Marayong",4400,57.894737,13676,159,6968,2657,6708,61.894775,51.58085,1193,11397,73.47162,85.13769,2651,69.67623,2257,83,1133,571,1346,5721,7941,6.6559744,1107,1247,15.406977,"116011304",53.478626,1832
2798,7395,4754,2249,957,74.32049,68.007256,805,"Doonside - Woodcroft",5496,59.14939,17097,161,8745,3307,8352,62.429417,48.34437,1676,15010,72.75173,84.60058,3117,68.28781,2637,120,1655,730,1893,7615,10250,10.619469,1510,1130,16.823406,"116011306",48.031025,2602
3050,7883,5437,2530,1494,80.21058,74.49941,843,"Lalor Park - Kings Langley",6323,64.39344,18928,228,9551,3396,9377,69.41146,56.813267,1495,15716,75.653046,87.97766,3402,74.8282,2993,155,1964,788,2259,7833,11760,9.022119,1387,1718,15.261045,"116011307",56.38796,2986
2731,7665,4918,2400,1421,79.530334,70.44321,776,"Seven Hills - Toongabbie",6096,60.820213,18147,222,9061,3407,9086,65.96915,55.201214,1482,15120,77.40952,86.172005,3558,72.84392,3066,130,1661,727,2032,7455,11014,8.0946455,1317,1606,15.622801,"116011308",52.361675,2625
582,1596,956,470,450,73.87218,63.68564,142,"Hadfield",1179,55.32646,4300,43,2254,738,2046,58.435207,44.93671,311,3232,69.7417,82.907135,743,66.05817,616,22,322,142,378,1636,2135,3.5598705,316,618,9.555555,"210031440",45.659164,542
1721,5255,3190,1528,835,77.6784,66.92948,615,"Blacktown (West)",4082,63.102848,12226,98,6136,2283,6090,63.419483,51.072124,1148,10285,76.009094,86.54174,2348,70.70491,2032,52,1086,524,1337,5030,7272,4.7016273,1026,1106,11.736526,"116011561",53.57143,1759
2014,5388,3963,1821,581,82.238304,76.41628,642,"Glenwood",4431,71.89672,12147,134,6178,2383,5969,71.17457,53.970966,1318,10956,86.69065,92.655365,2124,76.615555,1968,62,1448,632,1687,5568,8394,10.163935,1171,610,23.063683,"116021309",48.710167,1946
1841,4009,3045,1141,687,81.117485,75.413086,492,"Sunbury",3252,71.48289,9619,129,4923,1513,4696,72.79465,61.27865,875,8192,80.890976,87.60504,1428,76.867676,1251,80,1316,508,1380,4183,6297,10.810811,829,740,18.777292,"210041240",56.228573,1706
3470,8209,6398,2734,1528,83.42064,75.79706,1051,"Sunbury - South",6848,70.02882,20360,258,10623,3607,9737,73.12,63.359234,1740,16959,81.682846,89.227585,3379,78.10602,3015,174,2430,1060,2524,8750,13246,9.289909,1673,1873,16.884817,"210041241",60.402298,3090
0,0,0,0,0,0.0,0.0,0,"Moorabbin Airport",0,0.0,0,0,0,0,0,0.0,0.0,0,0,0.0,0.0,0,0.0,0,0,0,0,0,0,0,0.0,0,0,0.0,"208031192",0.0,0
2936,10845,7615,4501,845,78.054405,78.1288,894,"Parklea - Kellyville Ridge",8465,69.95913,23008,176,11318,5761,11690,73.48968,57.657658,1860,21207,80.39403,83.333336,5838,75.82402,4865,100,2054,960,2530,10362,16080,10.460251,1665,956,20.828402,"116021310",48.064518,3147
1702,5484,3809,2081,777,84.008026,76.00438,597,"Riverstone - Marsden Park",4607,64.042305,12477,141,6216,2738,6261,70.510925,58.41996,1032,10886,79.164215,91.6818,2753,77.31031,2524,76,1090,562,1345,5402,8416,9.336609,962,814,18.146719,"116021312",57.84884,1699
455,1247,1004,500,131,86.60786,79.2393,143,"Acacia Gardens",1080,73.84615,2839,27,1461,631,1378,75.77358,59.832638,249,2572,87.09677,93.94958,595,81.026436,559,25,336,143,351,1325,2084,18.382353,239,136,20.610687,"116021562",57.429718,403
898,3466,2707,1741,419,78.59203,79.89903,223,"Fitzroy",2724,60.02227,8042,84,4157,2179,3885,74.0832,61.0052,433,7120,67.37805,85.60273,2049,76.27809,1754,75,539,352,663,3654,5431,14.910537,577,503,20.047733,"206071142",51.501156,984
2654,7457,5653,2782,775,83.639534,74.58445,880,"Quakers Hill",6237,71.59005,16954,165,8722,3730,8232,72.00356,59.37287,1575,15308,83.67854,91.46482,3468,77.67181,3172,100,1900,871,2020,7851,11890,11.481056,1467,871,21.290323,"116021563",55.873016,2414
859,2469,1844,923,371,79.22236,76.344086,249,"Hughesdale",1956,72.64261,5960,55,3120,1209,2840,72.31373,51.244812,519,5019,80.64103,87.4359,1170,75.712296,1023,50,624,247,629,2550,3800,8.77193,482,570,14.824798,"208021180",47.97688,780
2848,6224,5108,2157,1477,85.636246,80.185875,667,"Greensborough",5330,72.40169,16081,260,8380,2690,7701,76.74279,64.221825,1202,12880,84.74849,90.54001,2537,81.040375,2297,171,2062,718,2106,6656,10438,9.918794,1118,1724,17.60325,"209011197",55.49085,2485
1994,4981,2530,1074,966,64.86649,47.438164,609,"Bidwill - Hebersham - Emerton",3231,45.68706,12552,99,6605,2264,5947,45.381165,36.82612,1343,10556,63.85885,74.48166,1881,54.575596,1401,60,911,485,1122,5575,5761,5.8252425,1317,1030,10.248447,"116031313",45.34624,1757
903,2687,1799,872,263,78.637886,67.44006,292,"Glendenning - Dean Park",2113,64.00886,6049,37,3099,1293,2950,64.992775,54.545456,589,5455,80.13937,88.43977,1237,71.71403,1094,37,578,312,690,2768,3912,11.178247,572,331,14.068441,"116031314",49.57555,861
2536,6761,4533,1945,636,77.72519,68.365555,872,"Hassall Grove - Plumpton",5255,65.57571,15175,115,7778,2845,7397,64.32524,51.980793,1706,13808,81.05691,87.63006,2595,70.886444,2274,59,1663,866,1994,7047,9788,8.0711355,1666,731,18.08176,"116031315",51.113716,2460
1857,5665,3192,1652,886,68.38482,56.75026,658,"Lethbridge Park - Tregear",3874,48.088314,13836,83,7285,2911,6551,51.860275,41.744774,1377,11820,62.914288,80.06304,2538,59.780033,2032,68,893,579,1101,6155,7066,6.0176992,1387,1130,9.367946,"116031316",47.78504,1750
2237,6802,3393,1655,987,66.9656,50.93875,645,"Mount Druitt - Whalan",4555,46.89316,15955,112,8166,3249,7789,48.561615,40.173218,1509,13789,64.29228,76.96503,3117,57.64015,2399,86,1049,603,1399,6987,7948,7.2943172,1501,1179,11.347518,"116031317",42.743538,2176
0,7,0,0,0,100.0,0.0,0,"Prospect Reservoir",7,0.0,7,0,0,0,7,0.0,0.0,0,7,100.0,100.0,4,100.0,4,0,0,0,3,0,7,0.0,0,0,0.0,"116031318",0.0,3
2526,6810,4482,2037,1008,78.79589,70.19297,806,"Rooty Hill - Minchinbury",5366,62.90578,16090,158,8272,2902,7818,64.507774,50.526318,1537,13758,78.86449,87.377625,2860,71.58017,2499,88,1589,768,1903,6948,9848,6.646526,1520,1324,15.674603,"116031319",52.43982,2413
0,4,7,7,4,200.0,100.0,0,"Banksmeadow",8,0.0,15,4,7,7,8,100.0,0.0,0,11,100.0,0.0,0,136.36363,0,0,0,0,4,7,15,0.0,0,0,100.0,"117011320",0.0,4
2054,5356,4733,2549,823,83.551155,85.27936,503,"Dulwich Hill - Lewisham",4475,73.66115,13152,135,6973,2989,6179,79.827965,62.641083,876,11285,79.51542,89.827324,2664,81.59504,2393,116,1513,555,1444,5929,9208,11.111111,886,1044,16.403402,"120031394",57.42009,1816
0,0,0,0,0,0.0,0.0,0,"Port Botany Industrial",0,0.0,0,0,0,0,0,0.0,0.0,0,0,0.0,0.0,0,0.0,0,0,0,0,0,0,0,0.0,0,0,0.0,"117011324",0.0,0
1129,2109,1508,492,808,78.80512,70.08547,187,"Creswick - Clunes",1662,65.367584,5887,149,2970,702,2917,69.94434,58.76923,336,4265,69.33208,82.95775,710,74.325905,589,87,738,191,737,2156,3170,10.687961,325,814,18.440594,"201021010",55.654762,1063
848,2758,2199,1255,353,84.73531,85.9589,276,"Sydenham - Tempe - St Peters",2337,75.58962,6212,40,3101,1460,3111,80.905075,63.90244,417,5476,79.13341,90.642075,1464,82.83418,1327,41,641,262,694,2718,4536,10.704961,410,383,11.331445,"117021328",66.18705,877
468,986,773,331,244,80.6288,73.88393,105,"Miandetta - Don",795,64.10256,2608,31,1378,448,1230,69.38959,62.626263,185,2100,76.81499,88.50267,374,74.666664,331,18,300,124,328,1114,1568,6.818182,198,264,12.704918,"604021088",56.756756,427
1197,3412,2717,1368,490,85.46307,83.51649,347,"Botany",2916,77.0259,7880,87,3978,1638,3902,80.24217,62.250454,605,6798,83.373886,92.376114,1574,82.86261,1454,84,922,343,1028,3386,5633,14.189189,551,592,17.755102,"117011321",57.355373,1233
1605,4012,2606,1168,1187,72.308075,67.281105,419,"Wendouree - Miners Rest",2901,57.694702,11014,133,5815,1736,5199,61.812145,48.57143,842,8228,68.045364,79.53321,1671,66.92999,1329,87,926,425,1020,4216,5507,5.4409003,875,1599,11.204718,"201011008",49.76247,1499
2322,8445,5656,3200,1224,77.8804,76.02756,782,"Mascot - Eastlakes",6577,64.03962,19446,195,9777,4209,9669,68.65744,49.50205,1749,16683,77.292206,87.0243,4362,73.32614,3796,124,1487,845,1804,8238,12233,8.05718,1707,1539,15.931373,"117011322",44.71126,2334
583,1404,767,254,523,61.89459,73.198845,80,"Beaufort",869,62.435677,3425,97,1498,347,1927,70.43159,56.603775,172,2493,54.48549,58.86076,474,65.62375,279,59,364,90,413,1089,1636,14.425427,159,409,18.546844,"201031014",46.511627,758
809,4767,2941,1939,465,87.64422,88.86343,279,"Darlinghurst",4178,74.04203,9029,126,3797,2182,5232,85.693474,70.97506,394,8199,76.784424,90.68989,2986,86.82766,2708,90,599,313,1065,3432,7119,24.657534,441,365,27.096775,"117031329",70.81218,1387
654,1361,885,339,374,76.1205,72.12766,115,"Golden Plains - North",1036,61.009174,3389,68,1654,470,1735,65.89725,50.684933,243,2704,70.6337,84.07643,471,71.0429,396,36,399,111,457,1343,1921,11.575562,219,311,18.181818,"201031015",47.325104,647
890,1525,1139,369,635,79.21311,74.84787,135,"Port Sorell",1208,63.820225,4470,77,2310,493,2160,70.17868,60.416668,243,3148,72.60101,85.918365,490,74.555275,421,57,568,145,575,1623,2347,8.296944,240,687,12.125984,"604021089",55.555557,792
1313,3416,2400,1102,746,78.13232,72.07325,349,"Pagewood - Hillsdale - Daceyville",2669,64.66108,8624,125,4462,1529,4162,67.815765,52.223816,733,6955,76.89796,85.939644,1458,72.88282,1253,85,849,364,942,3539,5069,9.209101,697,923,16.756033,"117011323",47.612553,1225
2046,6887,5956,3523,889,85.36373,87.63682,597,"Petersham - Stanmore",5879,77.27273,15895,176,8119,4020,7776,83.21922,66.54446,939,14044,77.38432,90.522194,3830,84.27087,3467,126,1581,726,1639,7157,11835,13.097713,1091,962,19.797525,"117021327",63.578274,2118
3,11,13,10,5,100.0,100.0,0,"Sydney Airport",11,100.0,29,0,13,10,16,100.0,0.0,0,24,100.0,100.0,6,100.0,6,0,3,0,5,13,24,0.0,0,0,0.0,"117011325",0.0,5
1499,10418,7043,4718,716,77.62527,74.089195,1270,"Sydney - Haymarket - The Rocks",8087,59.439625,22345,265,11211,6368,11134,67.018745,48.8645,2421,20927,78.75303,82.75808,6345,72.29894,5251,143,891,1291,1301,10509,15130,20.37037,2642,702,37.011173,"117031337",52.45766,1652
2526,5445,4399,1653,1339,85.05051,78.41556,648,"Normanhurst - Thornleigh - Westleigh",4631,74.6635,14190,256,7406,2108,6784,75.28667,54.09429,1189,11288,83.819626,91.82548,1994,79.99646,1831,206,1886,654,1896,5843,9030,13.179783,1209,1563,19.118746,"121021406",54.49958,2262
2883,8669,6979,4063,1464,79.85927,83.70416,729,"Marrickville",6923,65.972946,21043,168,10910,4854,10133,76.34832,63.247864,1316,17810,71.29865,88.31451,4604,78.057274,4066,126,1902,888,1960,9141,13902,7.1226683,1404,1769,11.47541,"117021326",55.395138,2749
1055,3350,2276,1159,566,71.9403,75.064766,303,"Maroubra - West",2410,70.14218,8045,83,4129,1544,3916,66.588646,38.705738,861,6768,80.73593,81.66134,1565,69.23759,1278,60,740,317,746,3418,4686,8.438819,819,711,14.664311,"118021568",35.19164,924
1511,2375,1896,588,950,83.57895,72.95285,171,"Daylesford",1985,67.10787,6952,208,3627,806,3325,73.31786,53.531597,307,4961,74.100716,84.95575,678,78.230194,576,150,1014,144,1030,2586,3881,14.409222,269,1041,21.894737,"201021011",55.700325,1390
847,1646,1230,411,454,86.87728,73.788155,180,"Gordon (Vic.)",1430,70.48406,4162,142,2062,557,2100,73.12723,60.791367,282,3328,77.345535,88.16327,490,79.92789,432,53,597,169,676,1682,2660,13.947369,278,380,31.277533,"201021012",63.82979,874
512,859,540,153,429,76.48428,59.07336,61,"Avoca",657,54.6875,2564,89,1276,259,1288,60.335194,50.0,115,1754,63.527054,77.55102,245,68.24401,190,45,280,62,317,895,1197,11.811024,124,381,20.74592,"201031013",53.04348,499
1335,6434,5271,3615,316,89.695366,90.42021,418,"Erskineville - Alexandria",5771,81.27341,13239,80,6489,3998,6750,86.90849,67.75956,623,12499,83.19378,93.79077,4139,88.34307,3882,75,1085,496,1391,6065,11042,17.688679,732,424,25.316456,"117031330",67.0947,1672
1707,5332,4960,2953,811,87.07802,86.21898,362,"Randwick - North",4643,78.32455,13159,187,7016,3425,6143,83.6566,62.358845,761,11261,84.484924,92.27929,2979,85.27662,2749,173,1337,497,1345,5929,9603,15.915363,797,1087,23.057953,"118021569",47.56899,1592
407,938,670,258,218,81.343285,79.38461,126,"Quoiba - Spreyton",763,67.81327,2275,39,1119,325,1156,73.30416,64.28571,196,1852,73.6211,89.53846,325,77.37581,291,19,276,117,307,914,1433,9.268292,182,205,17.889908,"604021090",64.28571,417
932,1836,1127,402,569,72.11329,67.44966,178,"Sheffield - Railton",1324,56.11588,4755,97,2350,596,2405,62.61111,54.044117,341,3636,64.87603,79.88615,527,67.40924,421,55,523,147,628,1800,2451,10.0,272,550,17.047451,"604021091",52.199413,968
1994,6737,5375,3057,842,78.61066,81.17366,620,"Glebe - Forest Lodge",5296,64.79438,16017,200,8438,3766,7579,72.16702,49.585308,1215,14185,72.35495,85.12221,3764,75.227356,3204,189,1292,837,1272,7448,10671,19.09091,1688,990,23.75297,"117031331",51.028805,1758
926,4581,3038,2173,193,83.84632,68.333336,299,"Point Cook - South",3841,60.691143,9648,34,4874,3180,4774,64.83141,49.482758,604,9267,79.70863,90.91512,3016,74.23114,2742,16,562,287,766,4686,6879,8.510638,580,188,17.616581,"213051466",49.50331,961
0,0,0,0,0,0.0,0.0,0,"Scrivener",0,0.0,0,0,0,0,0,0.0,0.0,0,0,0.0,0.0,0,0.0,0,0,0,0,0,0,0,0.0,0,0,0.0,"801081133",0.0,0
880,1850,1461,553,519,81.51351,75.753426,225,"Riverside",1508,71.13636,4974,91,2605,730,2369,72.97702,60.459183,399,3852,79.375,85.56068,651,77.07684,557,45,626,237,635,2002,2969,7.4626865,392,603,17.533718,"602011046",56.390976,800
951,2836,2104,1216,588,84.76728,71.02804,182,"Waitara - Wahroonga (West)",2404,64.24816,7300,87,3876,1712,3424,69.09688,52.6178,368,5881,79.74828,90.2133,1594,76.65363,1438,76,611,201,697,3045,4508,9.145608,382,831,14.795918,"121021579",49.45652,874
755,1681,1149,394,427,77.453896,64.802635,179,"Red Cliffs",1302,68.74172,4233,62,2125,608,2108,68.43359,61.392406,317,3360,73.324745,83.67347,588,72.94643,492,42,519,194,569,1679,2451,9.417041,316,446,14.519906,"215021399",56.466877,776
2026,5001,3391,1410,1341,71.28574,64.324814,566,"Mildura - North",3565,65.20237,13213,180,6871,2192,6342,64.34535,52.85171,1088,10271,67.331535,76.28766,2058,67.72466,1570,104,1321,556,1249,5270,6956,6.49594,1052,1601,13.422819,"215021469",52.02206,1855
1010,7105,4248,3036,638,83.40605,86.86695,460,"Surry Hills",5926,67.821785,13558,125,5815,3495,7743,81.58248,66.95157,681,12312,70.70544,88.197945,4567,82.63483,4028,57,685,470,1313,5207,10174,9.375,702,608,19.592476,"117031336",67.54772,1857
474,990,795,305,202,84.64646,79.22078,116,"Hadspen - Carrick",838,72.99578,2473,31,1281,385,1192,76.07655,65.053764,186,2035,81.51447,91.54929,355,80.2457,325,23,346,121,366,1045,1633,9.745763,186,236,15.346535,"602021056",62.365593,449
1821,9468,7230,4271,597,77.54542,85.19849,1012,"Newtown - Camperdown - Darlington",7342,77.70456,20623,135,10558,5013,10065,73.01555,46.512386,2202,19370,80.5709,87.25952,5094,75.22974,4445,117,1415,1427,1750,9902,14572,17.835365,3068,656,22.613066,"117031332",45.95822,2172
2996,6363,4662,1763,1498,79.5851,71.72498,632,"Gordon - Killara",5064,64.08545,16736,372,8875,2458,7861,66.81955,48.391335,1589,13340,81.03255,90.14755,2101,72.90855,1894,242,1920,737,2166,6977,9726,12.750263,1523,1898,24.83311,"121031407",39.77344,2673
3114,6778,5236,2088,1577,84.021835,76.39956,699,"Lindfield - Roseville",5695,68.240204,17529,412,9174,2733,8355,72.09142,52.40113,1554,14041,85.888504,90.01699,2354,77.85058,2119,281,2125,742,2465,7263,10931,14.704343,1416,1911,26.125555,"121031408",44.980694,2870
2320,4721,3834,1395,1098,85.914,77.7592,471,"Pymble",4056,71.336205,12324,338,6505,1794,5819,72.79286,51.60451,1035,9988,85.667755,91.476906,1537,78.9948,1406,189,1655,595,1841,5267,7890,15.266559,1153,1238,30.783243,"121031409",45.507248,2149
2790,5641,4596,1686,1728,88.15813,74.404236,599,"St Ives",4973,69.89247,15659,437,8290,2266,7369,73.79576,55.290104,1185,11869,86.22222,91.01464,1981,80.62179,1803,312,1950,648,2134,6228,9569,15.13094,1172,2062,25.289352,"121031410",50.548523,2475
2554,5105,4189,1487,1798,86.36631,79.17998,550,"Turramurra",4409,72.161316,14676,387,7773,1878,6903,76.05302,57.063198,1146,10613,85.252266,91.15854,1640,81.01385,1495,245,1843,614,1977,5508,8598,10.816777,1076,2265,21.523916,"121031411",47.99302,2319
2567,5126,4034,1343,1391,84.49083,77.05106,559,"Wahroonga (East) - Warrawee",4331,69.45851,13767,395,7250,1743,6517,72.22919,52.39216,1329,10711,87.51092,91.10816,1507,78.09728,1373,240,1783,668,2004,5585,8365,14.414414,1275,1665,28.396837,"121031412",42.0617,2290
2396,5566,5608,3059,1240,94.17894,86.1205,349,"Cremorne - Cammeray",5242,74.415695,14966,440,8160,3552,6806,84.99545,63.23077,633,12164,85.16675,93.77565,2924,89.19763,2742,355,1783,411,1711,6598,10850,22.727272,650,1562,35.48387,"121041413",55.13428,2009
1963,5932,5678,3467,875,92.0263,87.30798,360,"Crows Nest - Waverton",5459,75.54763,14621,286,7814,3971,6807,85.4863,71.18644,584,12574,81.87646,93.832596,3632,88.571655,3408,224,1483,504,1405,6642,11137,19.112629,708,1172,32.685715,"121041414",61.643837,1716
3897,7715,6878,3019,2105,92.417366,79.55204,626,"Mosman",7130,67.79574,21761,732,11941,3795,9820,76.0168,53.097343,1313,16763,86.13407,94.354065,3135,83.564995,2958,497,2642,720,2814,9048,14008,17.1794,1356,2893,34.774345,"121041415",47.677074,3267
1971,5555,5436,3280,1127,93.46535,88.219475,377,"Neutral Bay - Kirribilli",5192,72.754944,14517,347,7835,3718,6682,85.999054,68.82912,594,11876,81.425095,94.33564,3319,89.49141,3131,287,1434,435,1337,6321,10628,18.956408,632,1514,30.789707,"121041416",63.468014,1642
617,1552,1195,525,249,86.85567,76.642334,183,"Maiden Gully",1348,77.795784,3579,49,1778,685,1801,75.87302,61.904762,307,3127,84.86739,94.70199,604,81.32395,572,21,480,169,544,1575,2543,10.344828,273,203,19.678715,"202011023",59.60912,641
1103,2484,2058,886,515,86.99678,81.0613,294,"Strathfieldsaye",2161,74.07072,6181,109,3182,1093,2999,76.81971,62.1118,525,5163,84.03846,96.19151,919,81.71606,884,55,817,300,874,2679,4219,10.934394,483,503,21.165049,"202011024",56.0,1040
1723,7650,5388,3419,1006,89.56863,89.90271,548,"Potts Point - Woolloomooloo",6852,73.01219,15876,316,7220,3803,8656,87.15626,73.62805,709,13832,75.48358,91.352264,4718,88.490456,4310,228,1258,483,1678,6182,12240,21.965319,656,1038,31.411531,"117031333",77.29196,2223
1532,2868,2391,774,1103,91.841,81.55954,340,"Bayview - Elanora Heights",2634,72.78068,8227,267,4256,949,3971,80.74975,61.458332,575,5829,86.083916,92.23638,863,86.206894,796,207,1115,295,1231,2961,5025,15.984556,480,1295,24.206709,"122021421",59.130436,1430
2099,3912,3358,1118,1062,90.54192,80.60562,432,"Newport - Bilgola",3542,76.226776,10230,299,5256,1387,4974,80.54689,66.03221,754,8081,85.98425,93.615326,1253,85.385475,1173,189,1600,451,1638,4169,6900,17.387304,683,1087,28.154425,"122021422",57.29443,1905
3110,6836,5943,2430,1778,90.7402,83.47647,808,"Warriewood - Mona Vale",6203,78.58521,17988,405,9374,2911,8614,82.051636,64.81178,1277,14079,85.70932,94.11107,2683,86.27033,2525,277,2444,792,2465,7243,12146,12.998592,1222,2131,22.778402,"122021423",63.273296,2876
523,1126,757,235,347,88.099464,69.940475,93,"Mildura Region",992,71.70172,2821,129,1348,336,1473,73.99805,54.26829,179,2149,78.327644,86.14958,361,81.38669,311,58,375,89,459,1023,1749,17.846153,164,325,37.175793,"215021398",51.955307,586
1543,8169,5394,3397,687,74.73375,75.97853,749,"Pyrmont - Ultimo",6105,64.744,17999,212,9143,4471,8856,63.706154,34.773746,1949,16636,78.464676,84.01432,4748,69.121185,3989,145,999,853,1155,8467,11499,21.449703,2453,676,30.858807,"117031334",38.429966,1472
2023,3711,2797,946,1280,74.37348,70.33457,304,"Katoomba - Leura",2760,64.80475,10550,240,5559,1345,4991,69.45617,51.745068,648,7738,67.237686,80.334724,1195,71.81442,960,199,1311,341,1256,4027,5557,12.989556,659,1532,18.75,"124011452",46.91358,1868
1834,3279,2656,938,792,82.03721,73.74214,346,"Lawson - Hazelbrook - Linden",2690,70.77426,8634,146,4563,1272,4071,71.725624,52.931324,630,6982,78.97538,88.219894,1146,76.56832,1011,104,1298,316,1187,3703,5346,12.093023,597,860,18.434343,"124011453",54.920635,1503
3130,6323,5217,1924,1649,84.485214,79.96675,750,"Springwood - Winmalee",5342,74.12141,16886,276,8914,2406,7972,77.53009,62.7829,1293,13052,81.546135,91.18308,2223,80.89948,2027,224,2320,749,2289,6729,10559,10.251717,1193,2185,16.737417,"124011454",58.00464,2807
1364,3017,2316,982,865,79.151474,74.5634,302,"Blackburn South",2388,68.40176,8338,116,4456,1317,3882,71.17394,53.40314,627,6271,79.453186,85.46069,1183,75.01196,1011,95,933,306,959,3254,4704,7.9034944,573,1202,13.410404,"207031162",48.16587,1207
1393,8881,5338,3524,789,71.602295,80.77011,684,"Redfern - Chippendale",6359,61.73726,18729,127,9059,4363,9670,64.70303,35.0842,1812,17131,67.326256,83.10986,4997,68.279724,4153,79,860,875,1395,8250,11697,9.765142,2494,809,16.096325,"117031335",37.748344,2072
525,907,655,203,459,88.64388,70.24222,66,"Yea",804,62.666668,2699,125,1333,289,1366,69.606804,51.181103,122,1848,73.04015,88.16794,262,78.95022,231,58,329,65,382,941,1459,14.795918,127,392,27.233116,"204011062",54.098362,523
1423,2589,1947,630,1200,78.75628,67.52412,314,"Benalla",2039,65.917076,8074,168,4285,933,3789,68.65303,55.625,535,5425,72.12171,81.145584,838,73.474655,680,112,938,267,877,2836,3986,7.729469,480,1449,14.0,"204021063",58.69159,1216
619,986,788,233,373,92.08925,77.15232,82,"Benalla Region",908,66.882065,2711,140,1352,302,1359,74.40982,54.347828,147,2045,78.856155,88.16794,262,82.93398,231,66,414,75,455,1059,1696,22.525597,138,293,37.533512,"204021064",55.782314,577
1698,3869,3065,1370,921,83.277336,77.6644,362,"Bentleigh East (South)",3222,72.08481,10113,149,5323,1764,4790,75.01224,58.653847,700,7955,80.9373,90.125786,1590,79.03206,1433,105,1224,366,1278,4086,6287,8.488278,624,1237,16.178068,"208021427",51.714287,1579
2173,12746,7862,5392,1170,72.038284,80.4176,888,"Waterloo - Beaconsfield",9182,57.984352,27154,184,13238,6705,13916,65.05047,33.91521,2947,24832,68.519325,87.13981,7496,68.637245,6532,122,1260,1088,1578,12086,17044,10.590278,3208,1152,15.726496,"117031338",30.132338,2303
1707,5938,5105,3170,879,89.575615,86.683075,403,"Bondi - Tamarama - Bronte",5319,74.51669,13950,236,7133,3657,6817,83.51055,64.61949,746,12051,84.159546,93.191734,3437,86.49905,3203,179,1272,484,1477,6113,10424,17.549019,749,1020,26.848692,"118011339",54.021446,1755
1667,6793,5792,3895,737,89.41557,86.96137,432,"Bondi Beach - North Bondi",6074,73.18536,15382,210,7852,4479,7530,83.51839,65.01901,769,13728,84.045586,92.6915,4269,86.43648,3957,164,1220,513,1475,6935,11866,17.884405,789,917,28.493895,"118011340",56.176853,1755
1773,4108,3406,1482,1072,87.04966,75.53517,532,"Emu Plains - Leonay",3576,69.31754,10983,205,5803,1962,5180,74.72575,67.43621,840,8666,82.15902,91.10982,1721,80.56773,1568,140,1229,555,1271,4558,6982,11.24498,823,1245,19.123135,"124031459",63.333332,1547
1055,2751,2236,859,569,76.55398,75.816414,422,"Flora Hill - Spring Gully",2106,71.374405,7222,79,3902,1133,3320,71.02923,58.645832,780,5899,79.21109,83.44627,1033,73.6057,862,61,753,563,743,3148,4342,8.090186,960,754,13.884007,"202011021",54.102566,938
2300,5396,4033,1693,1602,77.2424,69.670784,649,"Kangaroo Flat - Golden Square",4168,65.13043,14991,167,7993,2430,6998,68.77558,63.580246,1113,11260,72.06538,83.78975,2264,72.83304,1897,121,1498,721,1455,5864,8201,5.683419,1134,2129,10.424469,"202011022",58.31087,2019
1651,4816,4388,2496,996,88.0814,85.30417,338,"Bondi Junction - Waverly",4242,75.59055,12492,229,6680,2926,5812,81.86567,59.25926,659,10176,82.50975,91.86713,2619,84.80739,2406,180,1248,464,1269,5360,8630,13.636364,783,1320,22.991968,"118011341",51.289833,1538
0,0,0,0,0,0.0,0.0,0,"Centennial Park",0,0.0,0,0,0,0,0,0.0,0.0,0,0,0.0,0.0,0,0.0,0,0,0,0,0,0,0,0.0,0,0,0.0,"118011342",0.0,0
2792,6882,6352,3347,1945,94.11508,84.75564,467,"Double Bay - Bellevue Hill",6477,66.58309,19105,833,10278,3949,8827,80.948135,53.707054,1137,14729,85.590775,93.42581,3316,87.10028,3098,552,1859,594,2079,7847,12829,22.706705,1106,2431,42.827763,"118011343",41.072998,2429
1284,3163,2649,1313,669,90.57857,81.552795,218,"Dover Heights",2865,69.470406,8124,265,4292,1610,3832,76.582825,46.54867,480,6622,84.214874,92.53225,1473,83.2679,1363,181,892,263,1019,3459,5514,21.728691,565,833,39.61136,"118011344",45.416668,1210
1481,2736,2234,715,958,92.032166,79.97763,271,"Wangaratta Region",2518,76.23228,7269,311,3575,894,3694,81.000725,55.091385,446,5494,82.28106,88.61689,817,86.494354,724,179,1129,211,1212,2758,4752,21.909424,383,817,32.463467,"204021067",60.762333,1473
1523,4798,4603,2748,805,91.7674,88.75969,351,"Paddington - Moore Park",4403,75.77151,11887,266,6284,3096,5603,86.00523,66.43929,558,10150,82.56042,93.097084,2709,88.729065,2522,214,1154,487,1264,5352,9006,22.961374,733,932,33.04348,"118011345",62.903225,1531
1537,3151,2527,1000,903,90.606155,76.80492,313,"Rose Bay - Vaucluse - Watsons Bay",2855,65.256996,8752,385,4698,1302,4054,69.40401,37.78055,710,6792,86.090775,91.25581,1075,79.24028,981,221,1003,303,1176,3641,5382,20.908232,802,1057,42.63566,"118011346",44.084507,1366
1456,3082,2536,970,647,82.998055,78.478966,359,"Surrey Hills (East) - Mont Albert",2558,72.66483,7944,159,4215,1236,3729,74.940895,56.936417,702,6466,83.29356,88.42387,1123,78.78132,993,114,1058,394,1047,3384,5094,13.718411,692,831,24.57496,"207031167",51.139603,1257
0,0,0,0,0,0.0,0.0,0,"Lake King",0,0.0,0,0,0,0,0,0.0,0.0,0,0,0.0,0.0,0,0.0,0,0,0,0,0,0,0,0.0,0,0,0.0,"205021083",0.0,0
887,2010,2019,1050,580,96.0199,84.951454,140,"Woollahra",1930,70.462234,5854,211,3264,1236,2590,83.189125,58.88158,264,4437,86.53846,93.222,1018,89.00158,949,165,625,179,630,2427,3949,19.713263,304,837,36.37931,"118011347",53.030304,728
2816,7817,7278,4209,1200,87.79583,87.14286,589,"Coogee - Clovelly",6863,74.005684,19349,296,10332,4830,9017,82.330315,64.48911,1044,16657,80.72384,92.791306,4231,84.89524,3926,215,2084,770,2052,8840,14141,14.410188,1194,1492,24.666666,"118021348",56.417625,2542
2898,7928,4970,2070,1780,66.30928,78.02488,652,"Malabar - La Perouse - Chifley",5257,70.63492,18489,295,8781,2653,9708,73.217445,51.09135,1514,14716,68.22967,66.20921,3279,69.49579,2171,221,2047,632,2139,6788,10227,11.088811,1237,1993,16.573034,"118021350",43.064728,3135
2310,4413,3558,1232,1207,85.42941,77.63075,392,"Brighton East",3770,72.42424,11954,326,6334,1587,5620,74.96839,53.59246,902,9159,85.37759,89.17598,1432,80.008736,1277,198,1673,455,1775,4746,7328,12.468513,849,1588,27.009113,"208011170",43.45898,2079
970,5666,3144,1592,585,59.58348,75.34312,762,"Kensington (NSW)",3376,68.86598,12422,135,6171,2113,6251,57.070248,32.769993,2538,11175,81.808395,78.1719,2199,58.34452,1719,89,668,795,760,5509,6520,13.444109,2426,662,23.076923,"118021564",30.023642,929
1297,5968,2999,1456,696,56.38405,68.10103,576,"Kingsford",3365,70.93292,13103,136,6439,2138,6664,53.53445,24.919243,2309,11570,78.289474,69.62751,2443,55.004322,1701,83,920,540,952,5602,6364,9.916368,2167,837,19.54023,"118021565",24.945864,1216
185,754,598,326,99,76.25995,81.09453,117,"Dickson",575,73.51351,1748,12,895,402,853,77.66234,68.30601,197,1524,73.595505,83.11346,379,76.968506,315,11,136,125,131,770,1173,8.8,183,125,12.121212,"801051054",59.39086,178
1142,3001,2301,1153,689,83.138954,82.122505,295,"Maroubra - North",2495,72.15411,7788,127,4098,1404,3690,74.03475,43.594307,599,6109,83.61582,88.43284,1340,78.50712,1185,79,824,245,888,3108,4796,7.979798,562,990,18.43251,"118021566",49.24875,1062
1329,3109,2499,1267,750,79.31811,78.74456,245,"Maroubra - South",2466,64.10835,8249,117,4390,1609,3859,71.584076,54.61121,542,6600,72.25994,88.47656,1536,75.22727,1359,78,852,302,745,3491,4965,8.676307,553,899,15.6,"118021567",45.202953,1031
1415,2316,1727,571,1419,74.52504,72.554,228,"Lakes Entrance",1726,59.293285,7642,176,3907,787,3735,67.3557,54.696133,386,4880,63.459984,77.489174,693,70.758194,537,119,839,198,785,2564,3453,8.86076,362,1343,12.403101,"205021084",59.067356,1237
1238,4139,3578,2077,559,81.6864,84.259636,336,"Randwick - South",3381,76.41357,10021,122,5323,2465,4698,78.43051,50.98952,769,8701,83.64888,88.360504,2208,79.97931,1951,117,946,438,972,4562,6959,15.374507,859,761,21.824686,"118021570",43.693108,1162
2057,5059,3889,1835,1155,84.1866,75.95199,593,"Jamisontown - South Penrith",4259,66.01847,12967,196,6753,2416,6214,71.76601,61.522198,924,10478,77.27778,89.0364,2335,77.76293,2079,114,1358,582,1391,5419,8148,8.545727,946,1334,16.969696,"124031461",64.17749,1800
2009,6070,4174,2123,860,78.79736,69.35642,773,"Kingswood - Werrington",4783,63.315083,14308,147,7378,3061,6930,65.97124,55.21082,1305,12397,74.4174,85.603386,2834,72.25135,2426,85,1272,694,1437,6327,8957,8.087536,1257,1051,17.093023,"124031462",59.233715,1931
2317,6214,3393,1469,1561,68.82845,55.665024,621,"Bass Hill - Georges Hall",4277,50.41001,15976,193,8201,2639,7775,53.065372,45.27121,1420,12608,66.41758,77.491066,2519,60.834393,1952,105,1168,651,1511,6394,7670,5.810736,1438,1807,12.36387,"119011354",43.732395,2275
1093,2987,2242,1028,550,91.329094,79.75175,427,"Mulgoa - Luddenham - Orchard Hills",2728,72.46111,6983,164,3446,1289,3537,76.5972,66.23853,643,5914,87.384895,94.435616,1258,84.03788,1188,61,792,361,949,2927,4970,11.753372,545,519,29.818182,"124031463",66.40746,1086
1343,3464,2790,1316,603,82.274826,77.502945,463,"White Hills - Ascot",2850,69.247955,8504,98,4437,1698,4067,74.300934,67.92717,732,7219,76.97369,89.248024,1516,78.12717,1353,59,930,485,936,3755,5640,8.651027,714,682,16.252073,"202011025",63.251366,1216
1046,2145,1700,632,471,85.08159,79.39699,223,"Bendigo Region - South",1825,73.61377,5255,104,2639,796,2616,76.5421,58.047493,393,4366,80.85714,92.45014,702,80.73752,649,78,770,220,849,2221,3525,18.660288,379,418,22.080679,"202021026",56.743004,1050
77,289,197,112,12,78.546715,68.29269,11,"Chullora",227,55.844154,636,0,335,164,301,62.341774,56.0,38,605,77.0115,90.85366,164,70.08264,149,0,43,42,67,316,424,0.0,75,19,0.0,"119011355",28.947369,87
1688,4830,2351,1164,795,67.30849,51.87166,431,"Bankstown - South",3251,44.37204,11473,92,5848,2244,5625,47.246784,37.452106,1077,9806,66.19718,77.68868,2120,57.12829,1647,47,749,391,1081,4976,5602,5.3899083,1044,872,11.572327,"119011572",40.01857,1633
1137,3335,1901,912,658,71.66417,57.794678,379,"Condell Park",2390,51.978893,8162,81,4169,1578,3993,54.50115,47.218628,810,6823,72.7897,79.55882,1360,62.890224,1082,33,591,365,848,3488,4291,4.845815,773,681,12.31003,"119011356",46.790123,1165
2711,6526,4767,2047,862,83.925835,74.30127,843,"St Clair",5477,67.133896,14977,195,7589,2755,7388,70.27864,61.958996,1380,13309,82.24449,90.0415,2651,76.970474,2387,84,1820,816,2052,6783,10244,10.421836,1317,806,22.621809,"124051470",61.086956,2495
2800,7489,3691,1636,1526,67.685936,50.66584,862,"Greenacre - Mount Lewis",5069,43.25,18464,168,9449,3229,9015,47.16933,42.316257,1930,15314,66.429375,78.4083,2890,57.20256,2266,84,1211,760,1773,7825,8760,5.172414,1796,1624,11.009174,"119011357",44.66321,2669
0,0,0,0,0,0.0,0.0,0,"Rookwood Cemetery",0,0.0,0,0,0,0,0,0.0,0.0,0,0,0.0,0.0,0,0.0,0,0,0,0,0,0,0,0.0,0,0,0.0,"125011475",0.0,0
1764,4027,2834,1107,991,79.76161,70.64455,457,"Kilmore - Broadford",3212,66.72336,10345,170,5327,1567,5018,67.945335,53.45238,910,8198,79.753525,86.76575,1413,73.749695,1226,101,1177,449,1359,4171,6046,8.737024,840,1156,17.15439,"204011056",50.21978,1704
1208,2338,1887,636,965,86.74081,79.8995,249,"Mansfield (Vic.)",2028,74.17219,6632,232,3329,796,3303,79.58667,58.310627,406,4709,73.84744,90.12179,739,83.13867,666,141,896,214,881,2371,3915,14.718163,367,958,24.04145,"204011057",61.330048,1193
575,1079,822,290,456,87.39574,77.747986,103,"Nagambie",943,66.95652,3093,91,1558,373,1535,73.72197,57.48503,168,2194,78.315414,88.38527,353,80.44667,312,51,385,96,437,1115,1765,11.512415,167,443,19.95614,"204011058",61.309525,558
841,1798,1170,383,537,72.080086,63.727123,195,"Seymour",1296,65.27943,4744,71,2409,601,2335,64.81995,49.86226,427,3603,70.12658,81.92771,581,68.44296,476,57,549,181,554,1805,2466,9.437086,363,604,13.221601,"204011059",45.667446,790
516,1482,819,314,304,89.74359,63.434345,270,"Seymour Region",1330,69.76744,3216,100,1430,495,1786,68.93939,57.062145,356,2670,79.333336,92.015205,526,80.48689,484,44,360,101,476,1188,2149,18.181818,177,242,32.894737,"204011060",75.8427,600
31,57,31,11,4,56.14035,50.0,3,"Upper Yarra Valley",32,64.51613,138,0,77,22,61,53.448277,0.0,11,115,52.77778,100.0,10,54.782608,10,0,20,0,19,58,63,0.0,5,19,0.0,"204011061",27.272728,36
2210,5033,3559,1531,1235,79.65428,74.46498,504,"Padstow",4009,64.84163,13062,192,6794,2056,6268,67.71309,51.71717,1016,10289,77.00507,87.73815,2047,73.55428,1796,83,1433,512,1517,5256,7568,5.396619,990,1538,15.546558,"119011358",49.6063,1970
562,1090,835,302,391,84.40367,77.237854,122,"Rutherglen",920,70.46263,3016,81,1535,391,1481,74.28825,52.046783,202,2214,75.2363,88.85794,359,79.268295,319,48,396,89,398,1124,1755,11.678832,171,411,20.716112,"204021065",60.396038,529
2383,4894,3930,1506,1623,80.42501,73.57108,579,"Wangaratta",3936,69.156525,14102,204,7585,2047,6517,72.81823,65.253365,941,10291,75.71023,84.410645,1841,76.43572,1554,145,1648,631,1599,5397,7866,6.6270566,967,2188,12.569316,"204021066",61.53029,2112
3235,7831,5857,2547,1733,81.228455,76.73998,882,"Panania - Milperra - Picnic Point",6361,67.51159,19694,260,10130,3319,9564,72.228386,60.321545,1602,15940,78.64353,89.11409,3059,76.64994,2726,188,2184,938,2493,8109,12218,9.302325,1555,2021,15.002885,"119011359",55.05618,3170
1994,4405,3163,1296,1373,82.22475,69.60258,505,"Drouin",3622,64.59378,12010,234,6232,1862,5778,67.599915,55.650063,886,9084,76.81564,87.21805,1729,74.691765,1508,121,1288,458,1375,4679,6785,7.7913713,823,1553,17.04297,"205011076",56.99774,1790
929,1746,1262,395,577,85.62428,74.24812,177,"Mount Baw Baw Region",1495,67.27664,4599,168,2276,532,2323,72.487076,53.92857,321,3487,77.25322,87.22109,493,79.0651,430,91,625,151,720,1741,2757,17.009346,280,535,29.116117,"205011077",55.140186,932
1033,2114,1650,668,660,84.578995,76.95853,228,"Trafalgar (Vic.)",1788,64.956436,5721,142,2947,868,2774,73.00885,63.231197,389,4374,76.89938,89.08122,751,78.60082,669,84,671,227,749,2260,3438,12.227075,359,687,21.515152,"205011078",58.611824,974
2516,5126,4004,1481,1615,84.82247,72.10321,671,"Warragul",4348,69.0779,14254,318,7513,2054,6741,70.84218,56.654343,1094,10778,80.453514,86.75424,1827,77.49119,1585,172,1738,613,1774,5652,8352,9.242343,1082,1861,19.690403,"205011079",61.334553,2205
0,0,0,0,0,0.0,0.0,0,"Alps - East",0,0.0,0,0,0,0,0,0.0,0.0,0,0,0.0,0.0,0,0.0,0,0,0,0,0,0,0,0.0,0,0,0.0,"205021080",0.0,0
1853,3645,2848,1035,1407,79.368996,70.60027,424,"Bairnsdale",2893,66.81058,10874,204,5822,1466,5052,69.83816,58.89328,734,7723,72.757256,83.29749,1395,74.336395,1162,128,1238,447,1103,4078,5741,7.3394494,759,1744,14.498934,"205021081",57.765667,1516
1155,2148,1629,520,892,86.359406,72.22222,214,"Bruthen - Omeo",1855,69.69697,5924,223,2884,720,3040,74.485596,57.371796,368,4335,75.62057,86.65644,652,80.36909,565,125,805,179,853,2187,3484,17.934002,312,697,25.0,"205021082",58.152172,1128
2035,4950,3463,1552,1022,77.89899,70.19448,484,"Revesby",3856,62.50614,12494,145,6522,2211,5972,66.32829,55.897434,1005,10171,75.79004,87.19923,2078,71.959496,1812,94,1272,545,1415,5221,7319,7.225211,975,1301,14.187867,"119011360",48.159203,1867
974,1663,1116,338,856,71.437164,71.1579,95,"Orbost",1188,61.909653,4959,154,2440,475,2519,66.786354,40.09009,242,3334,62.128967,74.77477,444,69.10618,332,86,603,89,607,1671,2304,11.183355,222,769,17.990654,"205021085",39.2562,977
914,1417,1025,323,1128,74.80593,72.421524,127,"Paynesville",1060,57.1116,5150,120,2605,446,2545,66.42903,53.005463,223,2960,61.945812,81.15183,382,70.439186,310,83,522,97,503,1543,2085,7.8154426,183,1062,10.638298,"205021086",56.950672,812
1263,2271,1667,520,1084,81.19771,74.498566,203,"Foster",1844,64.92478,6739,229,3384,698,3355,73.306946,55.91054,366,4545,68.09524,85.89147,645,77.249725,554,152,820,175,858,2274,3511,13.693694,313,1110,21.125462,"205031087",55.46448,1260
2315,6264,3241,1507,1241,68.48659,55.670483,633,"Yagoona - Birrong",4290,48.855293,15238,159,7733,2707,7505,51.241108,41.059093,1437,12589,67.45822,76.9291,2553,59.822067,1964,68,1131,535,1534,6325,7531,4.8295455,1303,1408,12.812248,"119011361",44.050106,2274
1074,3149,1518,704,479,69.41886,55.652172,292,"Berala",2186,50.55866,7031,56,3403,1265,3628,52.580532,41.240875,655,6036,69.27772,76.57181,1511,61.365143,1157,45,543,226,681,2887,3704,8.72093,548,516,11.691023,"125011585",44.580154,983
1355,2507,1899,639,831,84.12445,69.75983,242,"Korumburra",2109,66.56827,6925,191,3587,916,3338,70.489975,57.446808,437,5201,77.977165,85.30806,844,77.0621,720,115,902,243,956,2694,4008,12.877939,423,893,22.984356,"205031089",55.377575,1226
1481,2928,2257,802,1036,86.50956,73.04189,322,"Leongatha",2533,68.87238,8243,241,4279,1098,3964,73.37451,58.3501,578,6004,80.413895,88.46539,997,79.78014,882,145,1020,290,1088,3076,4790,12.053201,497,1203,23.262548,"205031090",55.709343,1353
1493,2593,1988,717,1226,79.52179,71.62837,204,"Phillip Island",2062,64.233086,8076,179,4257,1001,3819,69.48619,52.588554,376,5454,69.548874,85.00564,887,74.25742,754,119,959,193,925,2861,4050,8.524355,367,1396,14.600327,"205031091",54.255318,1330
1581,4921,2490,1275,727,70.148346,50.57517,442,"Bankstown - North",3452,45.5408,11623,89,5975,2521,5648,48.453007,43.00868,966,10060,65.2262,79.02183,2474,59.065605,1955,49,720,446,966,5139,5942,5.861244,1037,836,12.242091,"119011571",45.755695,1481
1749,4186,2796,1301,992,75.56139,69.202126,383,"Narwee - Beverly Hills",3163,55.688965,10930,120,5752,1880,5178,62.07815,50.057144,820,8690,73.57775,83.8565,1784,68.573074,1496,83,974,438,1164,4504,5959,6.650641,875,1248,12.096774,"119031370",46.707317,1582
2290,5849,3597,1721,1298,74.93589,66.91291,567,"Belmore - Belfield",4383,55.196507,14643,148,7496,2572,7147,60.241165,46.79892,1173,11820,71.91749,83.91663,2543,67.51269,2134,93,1264,519,1534,5971,7980,6.0983605,1109,1525,11.402157,"119021362",48.337597,2133
3524,10364,6130,3304,1685,73.726364,66.15939,902,"Canterbury (South) - Campsie",7641,51.333714,24374,191,12325,4994,12049,58.531464,47.36573,1995,20837,71.27595,82.72138,5093,66.089165,4213,91,1809,926,2335,10473,13771,4.913607,1955,1852,11.335312,"119021363",45.21303,3276
2957,6847,5042,2273,1945,82.255005,77.84247,651,"Kingsgrove (North) - Earlwood",5632,66.89212,18180,269,9388,2920,8792,71.044106,51.311474,1306,13944,81.27273,88.74955,2791,76.54906,2477,165,1978,626,2235,7097,10674,7.202095,1220,2291,13.830335,"119021364",49.84686,2750
1726,3952,3001,1220,941,82.059715,77.95527,456,"Oatley - Hurstville Grove",3243,69.640785,10041,173,5148,1565,4893,73.5359,59.113926,875,8033,82.05286,88.206894,1450,77.72937,1279,112,1202,467,1335,4081,6244,10.496719,790,1067,18.384697,"119031371",52.114285,1627
2272,5113,3908,1565,1601,84.607864,76.192795,623,"Peakhurst - Lugarno",4326,69.10211,14079,284,7365,2054,6714,73.15612,58.070866,1141,10455,82.07985,90.81408,1818,78.75658,1651,183,1570,590,1768,5342,8234,9.045971,1016,2023,17.738913,"119031372",54.601227,2154
3072,5623,4045,1431,2636,77.645386,69.941345,508,"Wonthaggi - Inverloch",4366,61.165363,17184,398,8925,2046,8259,67.40543,54.473385,924,11624,67.86343,82.454254,1858,72.35891,1532,254,1879,481,1928,6001,8411,8.68673,883,2924,15.098635,"205031093",54.978355,2841
1686,3364,2354,817,893,74.64328,67.97005,351,"Churchill",2511,61.803085,8648,170,4391,1202,4257,65.5893,56.348076,687,6953,71.53141,78.06789,1149,69.969795,897,100,1042,395,1093,3589,4865,12.468828,701,802,19.036955,"205041094",51.0917,1528
2149,4658,2921,1110,1465,67.90468,63.06818,542,"Moe - Newborough",3163,55.002327,12784,141,6661,1760,6123,60.078156,53.620148,1009,9520,62.469135,74.81527,1624,63.907562,1215,118,1182,511,1265,4862,6084,6.5591993,953,1799,9.624574,"205041095",53.716553,2025
1683,3750,2106,802,1232,63.093334,55.6172,360,"Morwell",2366,51.3369,10296,135,5314,1442,4982,54.306343,47.144753,782,7628,58.665035,68.38951,1335,58.626114,913,85,864,355,958,3878,4472,5.91922,753,1436,10.957792,"205041096",46.035805,1633
3218,7633,5788,2570,1764,80.086464,75.21217,889,"Traralgon",6113,64.60535,19789,264,10392,3417,9397,70.81855,62.678802,1505,15806,75.648705,86.03459,3122,75.29419,2686,175,2079,964,2274,8173,11901,7.8864355,1538,2219,14.965986,"205041097",59.069767,3006
633,1451,953,347,288,77.87733,67.50973,163,"Yallourn North - Glengarry",1130,66.824646,3411,47,1672,514,1739,67.63662,57.251907,276,2860,72.81977,86.036964,487,72.83217,419,33,423,150,501,1409,2083,12.547528,262,263,16.319445,"205041098",59.057972,688
8,10,8,0,3,100.0,0.0,0,"Alps - West",10,100.0,21,3,8,0,13,100.0,0.0,0,18,70.0,0.0,0,100.0,0,0,8,0,7,8,18,0.0,0,0,100.0,"205051099",0.0,10
628,1210,761,240,503,75.28925,72.289154,97,"Longford - Loch Sport",911,60.66879,3247,84,1534,332,1713,67.70463,55.487804,174,2334,63.10241,83.60215,372,71.63667,311,49,381,91,419,1124,1672,11.95122,164,410,16.6998,"205051100",55.747128,664
1882,3868,2870,1056,1216,82.34229,71.35135,452,"Maffra",3185,67.10946,10421,250,5337,1480,5084,71.1629,59.76155,762,7901,75.681816,85.51263,1346,76.63587,1151,150,1263,401,1332,4033,6055,11.503067,671,1304,20.55921,"205051101",59.317585,1760
554,1970,855,330,310,50.456852,74.1573,125,"Rosedale",994,67.68953,3722,96,1442,445,2280,72.70408,54.23729,303,3146,59.615383,37.336025,991,58.773045,370,54,375,96,403,1176,1849,20.300753,177,266,30.967741,"205051102",41.254124,676
1869,4020,2981,1231,1123,78.95522,70.26256,489,"Sale",3174,64.687,10928,149,5785,1752,5143,67.966255,58.169933,843,8406,73.54959,86.21347,1574,73.22151,1357,96,1209,445,1179,4386,6155,6.8620443,765,1399,13.268032,"205051103",58.00712,1603
824,1432,1023,303,665,77.93296,69.655174,110,"Yarram",1116,63.228157,4176,149,2079,435,2097,69.355934,51.851852,236,2907,68.46058,78.08564,397,73.58101,310,87,521,112,547,1475,2139,14.403974,216,604,22.406015,"205051104",46.61017,799
2111,6617,2870,1384,1051,66.67674,50.1631,711,"Punchbowl",4412,41.97063,15070,126,7402,2759,7668,45.218212,37.914692,1562,12964,63.573086,76.034485,2900,56.170937,2205,40,886,560,1370,6347,7282,3.791469,1477,1055,11.988583,"119021366",45.518566,2155
1427,3200,2706,1246,668,85.53125,79.820625,306,"Cheltenham - Highett (West)",2737,75.26279,8268,131,4400,1561,3868,77.73628,59.02637,566,6681,82.4575,92.01492,1340,81.46984,1233,95,1074,291,1067,3481,5443,10.337323,493,919,19.610779,"208011171",54.063602,1294
1598,4060,2554,1180,897,76.108376,65.591995,389,"Roselands",3090,58.385483,10178,116,5221,1799,4957,60.650677,48.15725,842,8271,74.949356,84.91652,1737,68.23843,1475,49,933,392,1110,4211,5644,4.8514853,814,1010,12.931995,"119021367",46.199524,1481
1295,5845,1784,913,666,66.5355,36.770035,472,"Lakemba",3889,43.243244,11839,51,5328,2483,6511,38.3491,30.549198,1092,10497,65.4054,73.26611,3273,54.044014,2398,44,560,267,968,4652,5673,6.508876,874,676,7.6576576,"119021573",43.223442,1480
810,3407,1318,730,380,68.53537,45.56804,299,"Wiley Park",2335,44.197533,7126,37,3339,1602,3787,44.243034,36.860672,677,6386,64.20188,77.31629,1878,57.20326,1452,21,358,209,547,2979,3653,5.8333335,567,360,9.736842,"119021574",44.165436,852
2628,8086,4803,2641,1221,70.603516,66.17389,777,"Hurstville",5709,51.636227,19158,153,9851,3991,9307,57.219444,40.338028,1906,16480,72.30971,80.27735,3894,63.786407,3126,89,1357,716,1653,8394,10512,6.108442,1775,1457,12.530712,"119031368",40.766003,2286
3035,7620,5804,2824,1379,82.414696,76.92727,803,"Mortdale - Penshurst",6280,66.88633,18855,236,9856,3671,8999,71.88506,58.991226,1448,15694,79.420395,89.26292,3446,76.99758,3076,143,2030,807,2165,8074,12084,8.024692,1368,1782,17.113852,"119031369",55.455803,2726
1446,3499,2005,986,800,67.33353,64.44444,291,"Riverwood",2356,47.02628,8868,75,4569,1530,4299,55.601776,45.079365,719,7105,59.70724,81.9838,1482,61.37931,1215,55,680,284,775,3606,4361,5.711319,630,963,9.375,"119031373",40.472878,1298
3014,7761,5286,2395,1586,76.832886,70.628136,858,"South Hurstville - Blakehurst",5963,64.06768,19343,298,9996,3391,9347,65.62383,45.575756,1856,15816,80.14842,82.46106,3210,71.124176,2647,208,1931,752,2160,8055,11249,10.716125,1650,1941,18.789408,"119031374",46.228447,2695
1102,3837,2670,1554,598,80.53166,73.92959,351,"Kogarah",3090,67.604355,8966,75,4531,2102,4435,69.422775,50.15576,678,7683,76.24148,88.22702,2132,74.97071,1881,49,745,322,783,3846,5760,7.1532845,642,685,12.541806,"119041378",51.769913,1027
1721,7706,5053,3194,905,77.082794,74.45222,739,"Arncliffe - Bardwell Valley",5940,58.28007,17227,132,8616,4290,8611,66.635895,48.85496,1508,15289,73.98609,84.79427,4472,71.90137,3792,88,1003,768,1277,7583,10993,8.518877,1572,1033,14.585635,"119041375",49.005306,1726
2974,8351,5648,2826,1608,78.55347,71.653145,817,"Bexley",6560,62.844654,20294,216,10335,3944,9959,66.548836,51.943913,1658,16838,77.50363,86.13157,3937,72.50267,3391,138,1869,815,2136,8487,12208,7.4675326,1569,1848,13.432836,"119041376",49.276237,2756
1594,3743,2740,1223,1021,80.41678,76.19938,345,"Kingsgrove (South) - Bardwell Park",3010,65.74655,9889,155,5125,1605,4764,69.490234,51.344086,738,7686,79.62185,87.06405,1577,74.81135,1373,87,1048,382,1137,3943,5750,7.360406,744,1182,15.181195,"119041377",46.747967,1428
597,1832,1697,976,462,91.64847,85.83993,128,"South Yarra - West",1679,70.68677,4932,181,2638,1137,2294,80.65589,53.243244,295,3936,87.17949,90.097084,1030,85.772354,928,102,422,197,442,2104,3376,19.101124,370,534,39.17749,"206041125",43.38983,507
2595,5158,4123,1526,1154,83.67584,74.69408,547,"Hampton",4316,71.79191,13295,271,6983,2043,6312,73.941895,57.782516,1094,10734,83.52393,89.606575,1703,78.61934,1526,192,1863,542,1972,5576,8439,13.646055,938,1407,23.483536,"208011172",50.0,2361
3128,8115,7407,3967,1215,87.0117,85.79152,684,"Leichhardt - Annandale",7061,77.20588,19842,270,10512,4624,9330,82.89871,65.59594,1165,17050,81.00539,92.46098,4165,84.85631,3851,249,2415,776,2256,8935,14468,15.789474,1183,1577,22.222221,"120021388",58.71245,2785
2196,5235,4266,1913,1441,85.76886,80.4796,563,"Miranda - Yowie Bay",4490,72.22222,14170,216,7494,2377,6676,77.33865,65.64157,972,10751,81.459564,92.12528,2235,81.44359,2059,148,1586,619,1652,5516,8756,7.4823055,943,1978,14.989591,"128011530",57.92181,2028
1928,5282,3689,1826,961,80.1401,74.89745,510,"Kogarah Bay - Carlton - Allawah",4233,66.13071,12633,172,6390,2438,6243,69.78812,53.913044,1045,10568,78.167854,88.069595,2414,74.96215,2126,92,1275,496,1425,5286,7922,8.333333,920,1104,17.898024,"119041379",48.80383,1823
1948,4266,3384,1362,1619,86.3338,79.18604,452,"Sylvania - Taren Point",3683,69.09651,12559,281,6674,1720,5885,75.23344,60.0,812,8764,81.15155,90.26659,1613,80.636696,1456,178,1346,498,1494,4498,7067,8.180147,830,2176,17.356392,"128011531",55.665024,1841
1678,4041,3160,1542,1092,84.013855,76.37444,344,"Monterey - Brighton-le-Sands - Kyeemagh",3395,67.93802,10804,184,5671,2019,5133,72.195564,54.705883,631,8418,78.91791,88.679245,1802,77.86885,1598,106,1140,372,1269,4377,6555,8.191654,680,1294,16.849817,"119041380",54.51664,1608
1801,7077,4462,2614,1061,79.53935,73.90444,711,"Rockdale - Banksia",5629,60.74403,15891,146,7753,3537,8138,68.142944,56.03306,1284,13625,74.585,85.739,4046,74.062386,3469,76,1094,678,1303,6548,10091,6.307054,1210,1205,13.760603,"119041381",55.373833,1747
2192,4387,3686,1568,1423,86.30043,78.32168,377,"Sans Souci - Ramsgate",3786,70.84854,12505,261,6695,2002,5810,74.96441,54.910095,686,9304,80.218636,90.2809,1780,80.30955,1607,168,1553,397,1541,4917,7472,9.448819,723,1778,18.341532,"119041382",54.95627,1921
3012,6413,5291,2230,1733,86.043976,78.57646,563,"Concord - Mortlake - Cabarita",5518,71.38114,17177,391,9031,2838,8146,75.65056,59.17832,1107,13407,81.57695,90.4048,2668,80.62206,2412,234,2150,677,2152,6994,10809,11.487481,1144,2037,22.56203,"120011383",50.858173,2638
2191,8922,5850,3670,862,74.501236,71.749756,718,"Concord West - North Strathfield",6647,60.93108,19974,163,10190,5115,9784,63.670006,38.73539,1842,18110,77.11777,83.06765,5144,69.00607,4273,116,1335,729,1493,9188,12497,11.576846,1882,1002,18.909513,"120011384",38.97937,1936
2354,5194,4779,2299,1303,91.933,83.84391,442,"Drummoyne - Rodd Point",4775,74.76636,14094,327,7597,2742,6497,81.24787,63.104324,746,11076,84.90099,94.3575,2428,86.258575,2291,224,1760,496,1715,5882,9554,13.061225,786,1715,25.095932,"120011385",59.24933,2020
2694,5876,5209,2542,1456,88.0531,82.34532,459,"Five Dock - Abbotsford",5174,73.27394,15840,311,8508,3087,7332,78.90033,59.68331,842,12478,81.665955,92.49538,2705,83.21045,2502,203,1974,490,1902,6602,10383,10.650578,821,1906,21.35989,"120011386",54.513065,2329
2150,4571,4214,2043,952,90.9429,83.72951,297,"Balmain",4157,74.27907,11763,316,6240,2440,5523,81.920685,60.108303,521,9715,82.15915,92.58546,2077,86.165726,1923,241,1597,333,1621,5144,8371,21.989052,554,1096,33.193275,"120021387",57.005756,1973
2189,9235,7618,4808,1059,81.147804,84.55856,911,"Brunswick",7494,70.53449,21328,162,11034,5686,10294,78.869446,63.67713,1586,18894,74.770424,87.34767,5580,79.98306,4874,130,1544,1136,1547,9659,15112,9.454545,1784,1375,15.29745,"206011105",57.4401,2069
2530,8484,5867,3293,1411,78.83074,75.44101,825,"Ashfield",6688,64.78261,20031,204,10136,4365,9895,69.895164,53.70247,1613,16878,76.53277,85.41944,4506,74.38677,3849,130,1639,805,1810,8394,12555,7.4626865,1499,1742,14.457831,"120031390",51.14693,2365
1835,4259,3974,2088,634,87.861,85.08557,278,"Lilyfield - Rozelle",3742,76.67575,10503,156,5610,2454,4893,82.77442,65.234375,473,9060,80.46972,92.52767,2168,85.165565,2006,145,1407,334,1302,4801,7716,17.923363,512,809,24.605679,"120021389",58.773785,1618
922,3861,3472,2242,411,82.41388,85.08539,330,"Brunswick East",3182,72.66811,9149,62,4877,2635,4272,80.110756,64.73617,598,8195,77.447334,88.15147,2456,81.195854,2165,57,670,503,625,4334,6654,10.497237,777,543,15.085158,"206011106",55.183945,807
2671,8370,5520,2869,1401,69.42652,70.83951,780,"Burwood - Croydon",5811,62.14901,20510,209,10739,4050,9771,60.826447,36.321156,2096,17445,73.53668,78.9501,3848,64.952705,3038,136,1660,855,1784,9075,11331,8.173077,2354,1664,14.917915,"120031391",37.21374,2426
1245,3058,2366,1064,568,81.066055,79.166664,283,"Pascoe Vale South",2479,71.80723,7520,81,3894,1344,3626,75.06345,60.035522,583,6210,81.23967,89.48617,1265,78.019325,1132,70,894,338,983,3152,4845,9.433962,563,742,14.260564,"206011109",48.542023,1210
1336,6080,3434,2169,424,77.56579,68.639244,592,"Homebush",4716,56.287426,12420,81,5916,3160,6504,63.136604,50.4772,1195,11519,73.5697,85.89462,3644,70.75267,3130,37,752,476,913,5439,8150,7.7568135,943,477,19.103773,"120031396",49.53975,1241
1352,3301,2588,1256,672,82.79309,81.55844,322,"Canterbury (North) - Ashbury",2733,72.04142,8202,113,4229,1540,3973,75.014496,51.792114,605,6751,82.032524,87.92633,1466,78.817955,1289,69,974,289,1009,3450,5321,8.85751,558,779,16.815475,"120031392",53.22314,1230
564,1995,1137,548,403,65.51379,65.2381,229,"Macgregor (Qld)",1307,59.574467,4928,71,2530,840,2398,54.98066,31.77711,591,4063,70.33195,72.451195,922,60.152596,668,42,336,211,339,2068,2444,9.090909,664,462,17.617867,"303031061",38.747887,482
2218,5227,4108,1867,1157,80.466805,76.76809,530,"Croydon Park - Enfield",4206,68.530205,13618,206,7234,2432,6384,72.387665,55.121952,1020,10902,79.78506,84.82024,2253,76.26124,1911,156,1520,565,1559,5675,8314,10.006414,1025,1559,17.804667,"120031393",51.960785,1954
810,4318,2570,1619,259,77.09588,69.09944,270,"Docklands",3329,66.54321,8893,118,4316,2343,4577,62.576088,36.68763,837,8425,83.21343,84.88855,2647,70.01781,2247,62,539,350,694,4107,5899,29.665071,954,209,45.559845,"206041118",32.258064,834
1728,4209,3520,1720,865,84.58066,83.739044,402,"Haberfield - Summer Hill",3560,76.21528,10554,138,5480,2054,5074,79.60199,59.84375,713,8631,82.641045,89.59108,1883,82.02989,1687,100,1317,383,1333,4422,7080,9.451796,640,1058,15.953757,"120031395",56.381485,1613
581,1598,1512,860,370,94.680855,87.93456,112,"East Melbourne",1513,72.11704,4135,160,2167,978,1968,85.81158,71.92118,177,3360,81.66023,90.58693,903,90.02976,818,87,419,146,423,1762,3025,21.481482,203,405,43.243244,"206041119",63.276836,518
2094,5819,2760,1179,1035,62.330296,52.988766,530,"Chester Hill - Sefton",3627,48.7106,13674,106,6820,2225,6854,49.524494,41.148327,1333,11392,65.54307,67.702126,2350,56.06566,1591,45,1020,516,1400,5573,6387,3.6086607,1254,1247,10.241546,"125031479",39.75994,2136
1628,4703,2005,918,955,60.535828,47.466393,444,"Fairfield - East",2847,40.110565,11356,89,5698,1934,5658,43.52073,37.894737,1063,9310,58.62857,68.14815,1890,52.116005,1288,38,653,396,1026,4607,4852,3.4830432,1045,1091,9.319372,"125031480",41.76858,1750
438,1149,839,353,200,79.1993,71.31313,136,"Strathfield South",910,70.091324,2774,42,1425,495,1349,70.622894,60.784313,254,2337,77.77778,84.96994,499,74.83954,424,24,307,155,308,1188,1749,10.126582,255,237,21.0,"120031576",53.54331,396
2624,8918,5602,2738,1376,78.649925,71.525604,1084,"Strathfield",7014,63.567074,20583,324,10289,3828,10294,65.66639,47.61905,2173,17449,80.726494,84.381386,4405,72.30214,3717,206,1668,990,1889,8531,12616,11.717861,2079,1758,23.54651,"120031575",49.884953,2340
1951,7212,3412,1782,894,67.58181,55.98492,751,"Granville - Clyde",4874,48.4367,15464,115,7358,3183,8106,52.85825,47.53974,1531,13667,63.194443,74.59754,3665,60.62779,2734,57,945,628,1274,6455,8286,6.3122926,1321,903,12.863535,"125031481",49.052906,2016
2849,7694,5622,2709,1860,82.49285,72.881355,781,"Greystanes - Pemulwuy",6347,65.005264,19603,253,10049,3717,9554,70.01245,59.153004,1431,15724,79.65243,88.91745,3501,76.11931,3113,195,1852,866,2200,8030,11969,9.658247,1464,2019,13.602151,"125031482",54.577217,2762
1925,6355,2553,1266,958,60.346184,45.05338,628,"Guildford - South Granville",3835,37.402596,14499,78,7186,2810,7313,41.54597,37.375885,1508,12500,55.42916,70.61449,2913,51.104,2057,40,720,527,1072,6145,6388,3.8424592,1410,1041,8.141962,"125031483",41.64456,1934
279,754,619,320,162,82.49337,86.25337,80,"Chifley",622,73.83513,1869,19,953,371,916,82.09549,69.23077,133,1508,74.4186,91.18457,363,82.294426,331,21,206,72,192,754,1241,10.552764,104,199,11.728395,"801091099",60.150375,258
1663,3602,2995,1123,766,88.201,82.21084,437,"Berowra - Brooklyn - Cowan",3177,80.45701,8874,162,4506,1366,4368,81.09938,63.403614,721,7295,86.19613,93.59375,1280,84.605896,1198,113,1338,421,1380,3693,6172,13.899139,664,813,21.148825,"121021404",60.610264,1601
2174,6433,3445,1644,1038,68.95694,56.01363,691,"Guildford West - Merrylands West",4436,52.483902,15192,128,7721,2935,7471,53.443996,44.801796,1453,12879,68.14634,75.76792,2930,61.19264,2220,61,1141,599,1397,6446,7881,4.7843137,1337,1275,12.331407,"125031484",47.556778,2050
1248,4010,2892,1723,477,83.49127,71.08086,310,"Hornsby - East",3348,62.900642,9348,72,4861,2424,4487,68.17539,55.964912,568,8252,78.163994,90.043106,2320,75.618034,2089,65,785,319,877,4242,6240,10.500808,570,619,15.094339,"121021577",54.577465,1122
3009,8970,6530,3772,1418,78.952065,71.46646,639,"Chatswood (East) - Artarmon",7082,58.65736,22301,291,11913,5278,10388,64.82033,44.54393,1648,19044,77.71203,87.3616,4787,71.47658,4182,197,1765,796,1970,10074,13612,10.712343,1787,1839,20.521862,"121011398",38.774273,2535
2885,6046,4875,1750,1552,85.77572,78.02051,684,"Pennant Hills - Cheltenham",5186,72.40901,15899,379,8301,2243,7598,74.95387,57.485466,1333,12550,84.08132,91.69041,2106,80.16733,1931,245,2089,791,2192,6504,10061,13.633834,1376,1797,24.420103,"126011496",51.312828,2607
3349,8097,5525,2472,1601,75.3736,70.04817,743,"Eastwood - Denistone",6103,62.167812,20168,288,10470,3529,9698,64.28904,46.21212,1807,16691,78.68072,82.35294,3349,69.66629,2758,178,2082,793,2314,8594,11628,9.488273,1716,1876,17.988756,"126021497",41.117874,2941
1845,4280,3666,1711,1041,86.799065,83.26034,407,"Gladesville - Huntleys Point",3715,74.63415,11202,227,5881,2055,5321,79.62641,59.801136,729,8884,81.052635,92.06953,1841,83.08195,1695,157,1377,421,1386,4604,7381,12.29444,704,1277,21.805956,"126021498",55.829903,1710
1328,2968,2133,794,902,78.13342,78.84806,294,"Hunters Hill - Woolwich",2319,69.35241,7892,283,4022,1007,3870,75.90747,55.789474,945,5778,83.532425,89.659225,851,77.05088,763,153,921,265,979,2810,4452,12.623762,475,1212,31.374723,"126021499",31.11111,1172
1927,7445,4865,2697,1105,71.28274,69.27819,666,"Macquarie Park - Marsfield",5307,65.905556,17955,203,9405,3893,8550,62.307888,37.52515,1872,15253,75.400116,81.471954,3886,66.68852,3166,152,1270,746,1272,7808,10172,9.517846,1988,1597,18.37104,"126021500",35.576923,1687
1646,3811,2865,1231,890,79.32301,79.36815,381,"North Ryde - East Ryde",3023,69.38032,9707,140,5006,1551,4701,73.80216,58.10219,740,7693,75.57777,87.89116,1470,76.53711,1292,94,1142,398,1210,3882,5888,8.362989,685,1124,15.730337,"126021501",51.48649,1601
2056,6637,4939,2906,927,81.84421,75.09044,508,"West Ryde - Meadowbank",5432,65.36965,15647,170,8083,3870,7564,70.607574,55.19177,983,13632,76.388885,87.89001,3782,76.07835,3324,99,1344,590,1430,6995,10371,9.099265,1069,1088,18.338728,"126021503",51.678535,1872
1975,3459,2932,837,1212,92.04973,78.66541,448,"Avalon - Palm Beach",3184,74.379745,9643,368,4972,1064,4671,80.30676,62.7451,729,7110,84.511024,90.84287,961,86.01969,873,242,1469,384,1495,3651,6116,18.319454,612,1321,30.363037,"122021420",61.45405,1769
2283,6783,5548,3116,1073,85.227776,80.74631,566,"Chatswood (West) - Lane Cove North",5781,70.08322,16455,249,8599,3859,7856,76.62984,59.107468,1066,14023,80.7766,90.36078,3631,80.788704,3281,183,1600,649,1685,7240,11329,13.465784,1098,1359,23.205965,"121011399",53.095684,2086
3336,8265,6658,3080,1747,85.311554,81.52461,705,"Lane Cove - Greenwich",7051,74.58034,20570,489,10558,3778,10012,79.3753,57.7708,1680,16653,85.215675,92.13641,3548,82.3215,3269,354,2488,736,2588,8388,13709,16.313364,1274,2170,27.99084,"121011400",41.964287,3037
1041,3580,3058,1931,405,91.22905,83.0895,230,"St Leonards - Naremburn",3266,74.25552,8265,116,4280,2324,3985,80.728615,61.70213,370,7368,82.6943,94.52116,2245,85.83062,2122,93,773,261,798,3788,6324,18.90244,423,492,28.641975,"121011401",62.162163,965
3455,7161,5737,2292,1753,86.83145,76.37454,644,"Willoughby - Castle Cove - Northbridge",6218,70.1013,18811,470,9897,3001,8914,73.68353,53.23308,1360,14947,84.30466,92.650505,2558,79.982605,2370,315,2422,708,2734,7786,11955,14.921838,1330,2111,26.81118,"121011402",47.35294,3243
2568,5709,4672,1832,1103,86.67017,78.999565,726,"Asquith - Mount Colah",4948,77.80374,13981,235,7169,2319,6812,78.49462,62.723003,1185,11661,84.67775,92.270294,2057,82.497215,1898,174,1998,668,2089,5952,9620,14.297453,1065,1217,21.30553,"121021403",61.265823,2467
1533,3297,1949,853,839,69.76039,63.51452,305,"St Johns Park - Wakeley",2300,45.140247,8672,98,4536,1343,4136,54.04881,48.08219,724,6903,68.669205,79.014305,1258,61.552948,994,53,692,351,903,3606,4249,5.6989245,730,930,11.680573,"127021520",42.12707,1315
1592,3659,2966,1231,1023,90.0246,80.82732,494,"Camden - Ellis Lane",3294,72.61307,9836,191,5154,1523,4682,77.97056,69.66618,715,7463,83.3448,93.76257,1491,83.88048,1398,99,1156,480,1211,3804,6260,7.3333335,689,1350,18.670576,"123011433",69.09091,1453
1398,4080,2672,1297,838,75.90686,70.14603,465,"Penrith",3097,59.728184,10263,113,5345,1849,4918,66.10589,59.119495,825,8122,69.04937,83.3509,1898,71.029305,1582,70,835,470,937,4042,5769,5.372218,795,1303,13.484487,"124031464",56.363636,1357
1384,3265,2385,1059,706,83.46095,74.21163,283,"Hornsby - West",2725,69.29191,8157,142,4186,1427,3971,71.10912,51.01289,565,6619,80.59937,89.24581,1432,77.201996,1278,90,959,277,1022,3354,5110,10.817307,543,832,20.113314,"121021578",50.088497,1268
0,17,0,0,5,76.47059,0.0,0,"Wetherill Park Industrial",13,0.0,26,0,4,0,22,0.0,0.0,0,17,100.0,63.636364,11,76.47059,7,0,0,0,6,0,13,0.0,0,4,0.0,"127021521",0.0,6
2691,5662,4635,1759,1400,86.36524,79.845665,663,"Blaxland - Warrimoo - Lapstone",4890,73.652916,14569,289,7507,2203,7062,77.62519,65.27391,1134,11633,82.92983,91.67862,2091,81.879135,1917,191,1982,703,2021,5971,9525,12.434896,1077,1536,20.642857,"124011450",58.465607,2437
4,4,4,0,0,100.0,0.0,0,"Blue Mountains - North",4,100.0,8,0,4,0,4,100.0,0.0,0,8,100.0,0.0,0,100.0,0,0,4,0,4,4,8,0.0,0,0,0.0,"124011451",0.0,4
683,1696,1248,479,253,85.96698,76.51757,258,"Warragamba - Silverdale",1458,74.23133,3849,56,1900,626,1949,75.59055,66.08187,388,3347,83.18841,92.23301,618,80.84852,570,36,507,226,574,1651,2706,14.457831,342,249,22.134388,"124031465",66.49484,690
1596,3986,3015,1233,1009,83.216255,72.74336,598,"Richmond - Clarendon",3317,67.85714,10635,169,5640,1695,4995,71.819916,62.624035,921,8184,78.38577,87.58578,1603,77.370476,1404,131,1083,568,1146,4198,6332,9.084604,907,1442,16.749256,"124041466",64.92943,1462
2000,4819,3579,1452,708,84.16684,70.65694,731,"Windsor - Bligh Park",4056,68.8,11503,168,5976,2055,5527,69.92966,62.182503,1103,9937,79.95418,89.39086,1970,76.83405,1761,90,1376,661,1396,5118,7635,10.489511,1063,858,23.728813,"124041467",66.273796,1746
819,2801,1426,556,373,63.584435,62.82486,337,"Yarramundi - Londonderry",1781,65.20146,5688,91,2514,885,3174,65.926956,62.527233,621,4964,72.69035,53.30544,1195,64.605156,637,49,534,287,716,2163,3207,13.960114,459,351,24.396782,"124041468",54.26731,985
1212,3574,3091,1765,671,93.25686,85.183395,214,"North Sydney - Lavender Bay",3333,70.29703,8699,263,4454,2072,4245,82.51468,63.419914,407,7320,83.03249,94.02623,2059,87.75956,1936,181,852,293,920,3746,6424,25.564972,462,708,39.195232,"121041417",52.579853,1108
2787,5735,4769,1939,1237,89.64255,78.78911,589,"Balgowlah - Clontarf - Seaforth",5141,72.58701,14672,341,7700,2461,6972,75.85494,54.956688,1059,12022,86.80583,93.9167,2137,82.432205,2007,236,2023,571,2204,6287,9910,16.702053,1039,1413,27.566694,"122011418",55.618507,2539
2256,7027,5880,3509,1328,91.06304,86.004906,472,"Manly - Fairlight",6399,70.6117,17058,353,8703,4080,8355,81.825775,63.64706,794,14213,81.929825,93.75158,3953,86.39274,3706,237,1593,541,1868,7186,12279,15.62294,850,1517,26.581326,"122011419",59.445843,2280
1848,4129,3284,1305,972,83.870186,81.869514,509,"Beacon Hill - Narraweena",3463,74.512985,10583,168,5482,1594,5101,78.041824,60.574413,873,8337,82.08785,89.62076,1503,80.92839,1347,138,1377,464,1439,4208,6747,10.832026,766,1274,17.28395,"122031424",58.304695,1753
970,2059,1798,703,587,91.403595,83.39265,262,"Cromer",1882,78.24742,5638,117,2992,843,2646,81.57895,66.751915,427,4263,88.01332,97.12722,731,86.32419,710,75,759,261,793,2204,3680,9.517767,391,788,19.931856,"122031425",61.358315,901
2885,8238,6763,3585,1151,88.565186,82.20592,796,"Dee Why - North Curl Curl",7296,75.493935,19281,232,9892,4361,9389,80.21587,66.24473,1228,16669,83.93051,92.983284,4247,84.34219,3949,215,2178,785,2319,8431,14059,14.715948,1185,1461,20.156385,"122031426",64.82085,2763
1625,3497,2871,1089,1009,86.47412,78.0086,396,"Forestville - Killarney Heights",3024,75.93846,9541,182,5035,1396,4506,76.478424,55.115963,740,7251,86.14113,92.14527,1184,81.29913,1091,144,1234,404,1355,3754,5895,11.241218,733,1281,18.03766,"122031427",53.51351,1573
3292,7049,5910,2189,2126,88.49482,81.95432,925,"Frenchs Forest - Belrose",6238,77.46051,18988,433,9813,2671,9175,81.03661,64.210526,1623,14342,88.06314,92.32704,2385,84.70227,2202,317,2550,854,2678,7293,12148,12.579365,1330,2520,20.366886,"122031428",56.99322,3041
2365,6818,5709,3068,961,88.970375,84.91558,621,"Freshwater - Brookvale",6066,78.09725,15832,212,8053,3613,7779,82.45234,67.33615,980,13742,83.098595,94.02003,3495,85.68622,3286,157,1847,637,1947,6924,11775,13.906112,946,1129,22.060354,"122031429",63.367348,2343
2047,4920,4176,1882,1027,87.5813,81.755,503,"Manly Vale - Allambie Heights",4309,79.57987,12348,206,6401,2302,5947,81.21354,62.9256,860,10062,85.02782,92.12674,2083,84.32717,1919,166,1629,499,1681,5142,8485,13.185067,793,1259,20.058422,"122031430",58.488373,1977
2932,7211,6209,2817,1896,90.1262,84.74729,755,"Narrabeen - Collaroy",6499,77.93315,19023,357,9916,3324,9107,83.375854,68.26196,1231,14658,85.54428,94.23631,3123,86.696686,2943,294,2285,813,2444,7447,12708,11.907655,1191,2469,18.829113,"122031431",61.33225,2857
530,1041,844,275,306,91.35447,83.08157,132,"Terrey Hills - Duffys Forest",951,73.396225,2773,84,1426,331,1347,78.95229,60.576923,224,2110,88.57143,92.04893,327,85.07109,301,54,389,126,434,1069,1795,15.12605,208,357,27.450981,"122031432",58.92857,490
2393,6467,5146,2429,894,87.24293,79.95392,889,"Elderslie - Harrington Park",5642,70.66444,15228,168,7867,3038,7361,75.26693,66.145096,1368,13304,85.886925,93.27821,2782,81.088394,2595,96,1691,930,1990,6837,10788,9.320389,1406,1030,18.791946,"123011434",64.98538,2317
3193,8964,7441,3669,880,87.72869,79.55334,1234,"Mount Annan - Currans Hill",7864,73.53586,20610,196,10766,4612,9844,76.23975,66.39386,1933,18724,88.066414,93.91304,4140,81.74001,3888,126,2348,1298,2546,9760,15305,12.524851,1955,1006,22.272728,"123011435",63.838593,2891
2114,5410,3631,1664,977,75.027725,62.6742,687,"Bradbury - Wedderburn",4059,56.05487,13625,164,7238,2655,6387,59.622334,51.703255,1282,11500,71.09031,82.91522,2312,66.86957,1917,99,1185,683,1291,6090,7690,8.623693,1321,1148,16.78608,"123021436",53.588142,1816
1867,5545,3579,1692,1153,77.49324,66.824646,623,"Campbelltown - Woodbine",4297,61.060524,13753,139,7055,2532,6698,63.774055,53.58615,1189,11157,76.2629,84.73161,2515,70.59245,2131,97,1140,650,1404,5612,7876,6.722107,1213,1443,12.055508,"123021437",52.396973,1841
2562,7512,5766,2840,852,85.46326,75.57211,1077,"Castlereagh - Cranebrook",6420,69.672134,17150,167,8786,3758,8364,72.96887,65.23388,1657,15414,83.22663,91.85649,3512,79.058,3226,109,1785,1032,1950,7902,12186,12.330317,1582,884,19.600939,"124031458",64.99698,2343
960,2261,1724,603,201,85.935425,76.42586,401,"Erskine Park",1943,72.708336,5001,48,2539,789,2462,74.37446,69.06854,578,4579,87.03297,90.81501,773,80.082985,702,30,698,393,792,2318,3667,13.57466,569,221,23.880596,"124051469",69.37716,910
2621,6473,4463,1843,848,77.66106,66.438354,883,"Claymore - Eagle Vale - Raby",5027,64.898895,14992,153,7671,2774,7321,65.4207,57.95375,1590,13295,80.0,83.35981,2518,71.38022,2099,92,1701,827,1892,6822,9490,10.836278,1427,849,18.042454,"123021438",55.53459,2365
0,0,0,0,0,0.0,0.0,0,"Holsworthy Military Area",0,0.0,0,0,0,0,0,0.0,0.0,0,0,0.0,0.0,0,0.0,0,0,0,0,0,0,0,0.0,0,0,0.0,"123021439",0.0,0
1422,3491,2823,1230,615,83.75823,78.09524,484,"Alfredton",2924,73.20675,8546,105,4440,1575,4106,75.219826,66.005295,818,7244,83.24154,91.08417,1402,79.334625,1277,53,1041,499,1058,3753,5747,7.7147017,756,687,17.073172,"201011001",59.168705,1271
2429,6367,4091,1811,984,77.99592,64.81747,701,"Ingleburn - Denham Court",4966,63.112392,14853,192,7502,2794,7351,63.71282,52.504173,1280,12788,76.50368,83.03314,2776,70.82421,2305,118,1533,629,1768,6421,9057,10.915818,1198,1081,19.512196,"123021440",54.765625,2311
1992,5060,3498,1549,1118,80.691696,69.24452,593,"Leumeah - Minto Heights",4083,63.30321,12602,218,6424,2237,6178,66.83225,55.12438,1044,10294,76.12022,85.956085,2186,73.644844,1879,134,1261,554,1393,5234,7581,11.260504,1005,1190,19.499105,"123021441",56.800766,1830
2670,7082,4303,2071,1103,73.97628,61.181683,659,"Macquarie Fields - Glenfield",5239,56.81648,16881,168,8696,3385,8185,57.680965,44.626335,1494,14542,72.58763,84.25713,3049,65.61684,2569,88,1517,627,1843,7460,9542,7.119741,1405,1236,15.231188,"123021442",44.10977,2539
2475,6472,3961,1747,776,76.37515,61.709644,761,"Minto - St Andrews",4943,58.747475,14802,122,7554,2831,7248,59.888115,51.37615,1434,13086,75.34071,85.16729,2690,68.04218,2291,88,1454,672,1769,6614,8904,9.361702,1308,940,15.721649,"123021443",53.06834,2348
2767,6347,4279,1645,1066,77.61147,63.34232,790,"Rosemeadow - Glen Alpine",4926,61.149258,15356,201,7943,2597,7413,62.376095,54.679146,1461,13207,77.00081,84.16252,2412,69.69789,2030,124,1692,818,1905,6860,9205,11.449677,1496,1083,18.855536,"123021444",54.07255,2474
704,1690,1265,522,421,85.08876,77.21893,222,"Bargo",1438,71.306816,4246,74,2135,676,2111,74.54331,65.29968,343,3387,79.066475,91.09375,640,79.80514,583,34,502,207,559,1697,2703,7.762557,317,438,17.577198,"123031445",64.72303,707
1163,2933,2323,1045,564,89.83975,81.76839,357,"Douglas Park - Appin",2635,73.00086,7067,112,3570,1278,3497,78.03158,68.097015,555,5910,86.76081,95.02008,1245,83.89171,1183,64,849,365,983,2977,4958,10.79258,536,593,19.858156,"123031446",64.324326,1133
2111,4938,3728,1524,1055,84.32564,74.23283,657,"Picton - Tahmoor - Buxton",4164,68.59309,12280,169,6287,2053,5993,71.7475,63.662792,1066,10134,82.4088,90.27258,1871,77.87646,1689,99,1448,657,1649,5196,7892,9.074244,1032,1091,16.018957,"123031447",61.63227,2001
1198,2783,2137,831,530,87.63924,76.94444,389,"The Oaks - Oakdale",2439,72.1202,6702,162,3389,1080,3313,74.877365,59.72222,602,5637,83.70307,89.89098,1009,81.17793,907,98,864,344,981,2854,4576,18.317757,576,535,30.566038,"123031448",64.61794,1172
877,1503,1130,374,571,78.043915,73.18983,107,"Blackheath - Megalong Valley",1173,64.5382,4331,103,2257,511,2074,72.25064,53.409092,209,3067,69.28747,83.125,480,75.08966,399,96,566,94,564,1564,2303,13.852814,176,693,18.038528,"124011449",51.19617,814
925,1562,1248,390,660,80.473755,69.76744,122,"Wentworth Falls",1257,68.21622,4818,109,2596,559,2222,73.3255,54.587154,270,3264,78.27715,81.262726,491,76.74632,399,108,631,119,627,1702,2505,12.080537,218,894,16.515152,"124011455",45.185184,801
0,0,0,0,0,0.0,0.0,0,"Blue Mountains - South",0,0.0,0,0,0,0,0,0.0,0.0,0,0,0.0,0.0,0,0.0,0,0,0,0,0,0,0,0.0,0,0,0.0,"124021456",0.0,0
1940,4826,3682,1649,901,84.27269,73.81379,592,"Cambridge Park",4067,67.68041,11787,142,6060,2234,5727,71.43966,63.469387,925,9980,79.164246,90.40404,2178,77.645294,1969,98,1313,622,1364,5154,7749,10.816777,980,906,15.760266,"124031457",64.0,1723
2605,6809,5676,2546,722,87.34029,81.186226,1018,"Glenmore Park - Regentville",5947,75.50864,15589,181,8058,3136,7531,78.28966,69.25116,1574,14059,87.66899,93.34288,2794,82.67302,2608,118,1967,1045,2140,7250,11623,14.60396,1509,808,25.069252,"124031460",64.67599,2441
1345,3541,2260,994,653,76.673256,64.41996,453,"Colyton - Oxley Park",2715,58.884758,8573,71,4379,1543,4194,61.313076,53.634087,799,7227,73.69295,84.775536,1537,68.83907,1303,46,792,428,888,3686,4975,6.6378064,798,693,10.872894,"124051580",56.69587,1205
1600,4841,2784,1319,848,73.64181,60.61581,588,"St Marys - North St Marys",3565,54.625,11508,115,5819,2176,5689,58.084705,52.01573,1032,9634,67.92676,80.90737,2116,65.902016,1712,62,874,529,1150,4793,6349,6.042885,1017,1026,13.56132,"124051581",56.976746,1693
1520,7282,4173,2718,443,67.42653,69.51407,337,"Homebush Bay - Silverwater",4910,64.539474,14411,101,6686,3910,7725,66.51259,48.104267,906,13556,68.7355,70.65778,4652,67.00354,3287,68,981,406,1185,6274,9083,16.504854,844,412,22.799097,"125011473",37.19647,1724
1499,6581,2139,1098,645,62.98435,45.94142,724,"Auburn - Central",4145,39.959972,12961,72,5735,2390,7226,42.499504,36.53846,1532,11614,61.68996,68.431656,3475,54.107113,2378,24,599,418,971,5033,6284,3.4188035,1144,702,11.16279,"125011582",47.258484,1574
792,4828,1517,856,311,66.3836,49.28037,525,"Auburn - North",3205,44.444443,8645,31,3506,1737,5139,47.8851,46.165886,1021,7996,58.635395,73.16138,2869,59.054527,2099,14,352,295,550,3168,4722,4.1420116,639,338,9.967846,"125011583",51.420177,938
860,2786,1188,572,401,63.67552,50.35211,285,"Auburn - South",1774,43.139534,6251,37,3064,1136,3187,45.833332,35.57047,657,5378,65.27149,70.28113,1245,55.076237,875,33,371,212,577,2592,2962,6.9915257,596,472,9.226933,"125011584",43.378994,884
2323,7355,4009,2090,882,71.18967,65.47619,682,"Lidcombe",5236,54.15411,16022,122,7785,3192,8237,58.67974,45.102505,1518,14187,74.537895,76.74925,3673,65.16529,2819,67,1258,594,1613,6832,9245,7.0304303,1317,953,13.832199,"125011586",44.927536,2164
635,1670,848,370,265,68.68263,57.275543,155,"Regents Park",1147,52.598427,3848,27,1913,646,1935,52.572845,39.156628,349,3283,69.268295,76.34561,706,60.76759,539,14,334,130,426,1613,1995,4.6666665,332,300,10.18868,"125011587",44.41261,615
3625,8435,5810,2407,1998,79.05157,68.28369,812,"Carlingford",6668,64.441376,21494,377,11061,3525,10433,66.06777,50.121655,1867,17229,79.660515,87.35203,3210,72.4244,2804,243,2336,824,2675,8794,12478,10.719012,1644,2267,18.86887,"125021476",43.492233,3358
2709,6790,4551,2171,1265,76.3623,70.28165,602,"Ermington - Rydalmere",5185,60.908085,16354,195,8299,3089,8055,65.60473,52.765583,1291,13727,73.22275,85.406136,2967,70.92591,2534,129,1650,601,1854,6937,9736,9.471366,1139,1362,15.41502,"125021477",46.63052,2532
2293,5517,3783,1752,1047,76.72648,68.27747,502,"Oatlands - Dundas Valley",4233,60.226776,13687,186,7123,2566,6564,63.644012,48.940094,1099,11461,74.636665,85.47046,2285,69.94154,1953,119,1381,531,1592,5944,8016,10.0933,1085,1179,17.765043,"125021478",45.67789,2133
2877,9385,4842,2482,1323,70.31433,56.770355,951,"Merrylands - Holroyd",6599,52.24192,21238,183,10530,4372,10708,54.173195,45.29307,1908,18323,67.26937,76.40025,4767,62.440647,3642,92,1503,765,1823,8938,11441,5.7788944,1689,1592,13.832199,"125031485",49.842766,2710
0,3,0,0,0,100.0,0.0,0,"Smithfield Industrial",3,0.0,3,0,0,0,3,0.0,0.0,0,3,0.0,100.0,3,100.0,3,0,0,0,0,0,3,0.0,0,0,0.0,"125031486",0.0,0
0,6,0,0,0,100.0,0.0,0,"Yennora Industrial",6,0.0,6,0,0,0,6,0.0,0.0,0,6,100.0,100.0,3,100.0,3,0,0,0,3,0,6,0.0,0,0,0.0,"125031487",0.0,3
2084,7469,4731,2842,916,77.0652,68.120804,522,"North Parramatta",5756,60.55662,16861,142,8476,4172,8385,64.60467,48.73477,1192,14792,71.13557,85.78775,4278,70.89643,3670,107,1262,520,1422,7323,10487,9.280139,1067,1153,15.502183,"125041489",43.791946,1999
1041,2281,1752,692,661,87.768524,73.07286,240,"North Rocks",2002,70.509125,6096,144,3154,947,2942,72.848236,55.8753,453,4686,85.37095,91.96326,871,80.11097,801,93,734,233,817,2405,3754,12.416555,417,749,21.785173,"125041490",52.980133,957
1619,6337,4475,2876,878,84.86665,69.03504,403,"Northmead",5378,66.02841,14926,157,7711,4166,7215,68.57187,54.25101,770,12863,79.53297,89.029434,4111,76.59955,3660,128,1069,402,1158,6526,9853,10.801688,741,1185,17.88155,"125041491",52.33766,1456
1730,10936,5592,4101,678,80.58705,62.296825,859,"Parramatta - Rosehill",8813,48.034683,21985,122,10371,6583,11614,58.189384,47.10871,1533,20546,66.054504,87.06416,7715,70.11097,6717,49,831,611,1115,9610,14405,6.438896,1297,761,17.9941,"125041492",56.03392,1688
2566,6697,4622,2165,1545,80.21502,72.65101,708,"Toongabbie - Constitution Hill",5372,66.44583,16939,198,8697,2980,8242,69.129524,53.77193,1314,13383,78.49554,86.435646,3030,74.67683,2619,139,1705,613,1847,6686,9994,6.911984,1140,2011,12.815534,"125041493",53.88128,2353
1247,3130,2576,1207,852,86.74121,81.94161,309,"Winston Hills",2715,72.49399,8217,137,4235,1473,3982,79.11548,64.36567,569,6386,83.76353,92.867645,1360,82.85312,1263,120,904,345,1006,3256,5291,12.257405,536,979,16.079813,"125041494",54.3058,1201
1176,4043,2256,1289,686,76.99728,64.35347,281,"Pendle Hill - Girraween",3113,56.29252,9343,76,4614,2003,4729,60.36928,44.623657,636,7780,72.79472,85.36919,2194,69.010284,1873,56,662,249,883,3737,5369,6.3854046,558,877,11.078717,"125041588",44.18239,1213
1445,5294,2830,1677,667,76.65282,61.836285,404,"Wentworthville - Westmead",4058,53.14879,11702,94,5741,2712,5961,58.039375,45.89708,898,10170,70.09472,86.497604,2918,67.728615,2524,55,768,330,1036,4876,6888,6.3583813,719,865,14.092954,"125041589",44.988865,1478
640,1238,1021,330,293,84.652664,78.75895,148,"Putney",1048,75.3125,3208,74,1677,419,1531,75.62963,57.044674,290,2588,84.60207,91.08108,370,79.94591,337,43,482,166,489,1350,2069,13.149847,291,327,25.255972,"126021590",51.03448,578
3019,8672,6451,3311,1650,81.26153,74.38778,792,"Ryde",7047,68.59888,21383,286,11061,4451,10322,71.29752,55.449936,1622,17720,80.87115,87.10128,4295,76.17381,3741,194,2071,875,2228,9048,13498,9.637357,1578,2013,17.333334,"126021591",48.828606,2755
1857,4832,1965,814,807,53.000828,40.96628,457,"Ashcroft - Busby - Miller",2561,35.325794,11741,49,6102,1987,5639,38.81098,37.57178,1211,9895,49.614536,63.933517,1805,45.740273,1154,37,656,458,901,5063,4526,3.5611165,1219,1039,6.0718713,"127011504",37.737408,1816
1035,2698,1620,608,695,82.32024,64.74973,415,"Austral - Greendale",2221,61.739132,6617,150,3224,939,3393,64.05694,54.774776,679,5227,78.113556,86.62352,927,73.48383,803,69,639,304,853,2529,3841,9.928058,555,695,21.582733,"127011505",61.119293,1092
1638,5460,4084,2302,791,88.553116,78.113335,636,"Cobbitty - Leppington",4835,65.26251,12636,170,6385,2947,6251,73.41363,61.65644,981,11023,84.15165,93.205574,2870,80.912636,2675,110,1069,603,1354,5563,8919,13.381995,978,822,21.491783,"127011506",64.8318,1609
3,19,6,0,9,78.947365,0.0,5,"Badgerys Creek",15,0.0,44,0,16,0,28,50.0,66.666664,5,31,60.0,100.0,4,67.741936,4,0,0,6,6,12,21,0.0,9,4,0.0,"127011592",100.0,10
976,2348,1562,623,268,76.703575,71.444954,309,"Cecil Hills",1801,61.885246,5328,57,2712,872,2616,64.3063,53.35628,595,4777,80.76923,83.185844,791,70.39983,658,25,604,310,777,2429,3363,8.833922,581,283,21.268656,"127011593",51.932774,962
1651,4053,2374,1010,500,70.17024,61.360874,424,"Green Valley",2844,51.483948,9436,74,4883,1646,4553,54.839455,46.705425,1000,8382,74.34253,79.45114,1494,62.252445,1187,32,850,482,1159,4329,5218,5.776173,1032,554,14.8,"127011594",42.4,1559
1537,4057,2541,1141,418,74.340645,65.461845,472,"Hinchinbrook",3016,57.644764,9157,75,4682,1743,4475,59.915115,49.739853,992,8298,76.49484,84.2236,1610,66.96794,1356,36,886,478,1113,4241,5557,8.163265,961,441,17.942583,"127011595",47.580647,1455
1253,3672,2463,1271,319,78.8671,68.963646,396,"Hoxton Park - Carnes Hill - Horningsea Park",2896,60.893856,8243,53,4252,1843,3991,63.170044,50.1868,801,7571,80.456024,88.80097,1643,70.78325,1459,26,763,403,988,3899,5359,7.365439,803,353,16.61442,"127011596",49.4382,1228
1519,4819,3347,1765,414,80.141106,72.01142,541,"West Hoxton - Middleton Grange",3862,65.24029,10629,71,5396,2451,5233,66.94,53.59223,1066,9819,82.585754,89.31605,2237,73.418884,1998,39,991,552,1252,5000,7209,9.848485,1030,396,17.14976,"127011597",50.75047,1516
751,1946,1511,682,451,80.78109,81.67664,235,"Chermside West",1572,73.10253,4921,55,2524,835,2397,77.36815,62.12534,411,3899,77.24317,89.81723,766,79.071556,688,52,549,228,594,1953,3083,9.106831,367,571,12.195122,"302021029",57.177616,769
2296,5143,2773,1202,841,66.595375,58.66276,553,"Bonnyrigg Heights - Bonnyrigg",3425,42.726482,12415,97,6431,2049,5984,50.335815,47.5945,1290,10652,66.99079,77.198524,1899,58.186256,1466,36,981,554,1309,5509,6198,3.9045553,1164,922,11.533888,"127021509",42.868217,1954
2727,6019,3636,1403,1248,73.533806,63.541668,703,"Bossley Park - Abbotsbury",4426,53.392006,14868,209,7601,2208,7267,57.90731,52.38095,1368,12298,72.12371,79.29021,2226,65.555374,1765,73,1456,704,1749,6279,8062,5.5219364,1344,1322,16.746796,"127021510",51.38889,2425
3072,7877,3692,1784,1463,62.14295,51.875546,705,"Cabramatta - Lansvale",4895,37.858074,19205,122,9865,3439,9340,44.854816,38.372093,1804,16108,60.68053,73.88755,2899,53.308914,2142,85,1163,660,1926,8231,8587,5.201958,1720,1634,8.339029,"127021511",39.079823,3174
4,13,4,0,3,100.0,0.0,4,"Braeside",13,100.0,20,0,4,0,16,100.0,0.0,4,17,100.0,100.0,3,100.0,3,0,4,0,6,4,17,0.0,0,0,0.0,"208031184",100.0,6
1119,2991,2121,933,669,80.00668,75.977196,365,"Boondall",2393,70.68812,7308,98,3648,1228,3660,74.447174,62.749004,695,5840,79.57814,87.78931,1253,77.29452,1100,82,791,315,830,2849,4514,10.262829,502,799,14.648729,"302031035",52.517986,1043
21,105,26,12,11,25.714285,52.173912,3,"Brisbane Airport",27,47.61905,174,0,58,23,116,50.0,50.0,19,157,58.333332,16.129032,62,33.75796,10,0,10,4,14,52,53,0.0,8,6,0.0,"302031036",15.789474,24
1604,3421,2805,1062,939,78.690445,77.01233,362,"Ballarat",2692,73.31671,9397,181,5037,1379,4360,74.5614,56.73941,787,7183,79.88748,83.58086,1212,76.527916,1013,125,1176,442,1136,3762,5497,9.803922,779,1275,19.275826,"201011002",45.99746,1422
1350,3578,2934,1493,711,86.97597,81.85307,378,"Caringbah",3112,72.74074,9080,108,4791,1824,4289,79.04095,65.98513,585,7290,80.61056,92.58843,1781,82.93553,1649,104,982,355,977,3712,6046,9.638555,538,1079,15.189874,"128011602",64.61539,1212
1631,3474,2890,1080,998,88.62982,83.07692,490,"Caringbah South",3079,73.39056,9287,204,4815,1300,4472,79.3738,68.73239,770,7115,83.37766,94.25,1200,83.89318,1131,125,1197,488,1254,3641,5969,10.64736,710,1174,20.440882,"128011603",63.636364,1504
2056,5233,2696,1248,964,65.794,57.300274,531,"Cabramatta West - Mount Pritchard",3443,43.190662,12814,102,6617,2178,6197,49.35921,42.18241,1279,10695,64.512924,77.85788,1942,57.400654,1512,42,888,518,1298,5462,6139,3.6363637,1228,1155,10.580913,"127021512",41.51681,2012
2627,6653,3296,1554,1064,61.476025,55.08685,607,"Canley Vale - Canley Heights",4090,41.22573,16030,98,8313,2821,7717,47.247707,39.725132,1637,13629,61.357502,74.04044,2423,54.193264,1794,52,1083,607,1591,6976,7386,3.8893044,1528,1337,9.210526,"127021513",37.080025,2593
1481,3214,1870,721,539,71.65526,60.435875,384,"Edensor Park",2303,49.898716,7726,97,3973,1193,3753,54.2029,48.06701,780,6664,70.255615,80.05249,1143,62.62005,915,37,739,373,907,3450,4173,7.0745697,776,523,17.99629,"127021514",49.23077,1291
2138,5665,2177,1082,968,52.285965,44.25358,421,"Fairfield",2962,31.290926,13558,66,6925,2445,6633,38.219803,34.32165,1175,11361,50.576923,59.045643,2410,45.233696,1423,44,669,382,1052,5696,5139,3.5801466,1113,1229,6.818182,"127021515",35.82979,2080
2995,7444,6198,2948,1684,90.66362,85.67277,802,"Cronulla - Kurnell - Bundeena",6749,73.72287,18615,404,9487,3441,9128,82.14712,68.62038,1131,14989,82.321365,92.707085,3332,86.37668,3089,281,2208,761,2454,7545,12947,14.469619,1109,1942,23.9905,"128011604",70.9107,2981
473,973,797,257,246,91.26413,85.38206,156,"Lilli Pilli - Port Hacking - Dolans Bay",888,73.15011,2443,69,1224,301,1219,81.1609,70.19231,240,1955,88.17204,94.402985,268,86.189255,253,48,346,146,410,982,1685,19.834711,208,242,28.04878,"128011605",65.0,465
1068,2352,1978,738,549,89.710884,83.76845,315,"Woolaware - Burraneer",2110,76.02996,5963,149,3062,881,2901,80.9329,68.08081,487,4796,84.22035,93.702774,794,85.2377,744,91,812,337,902,2444,4088,14.724919,495,618,27.140255,"128011606",64.681725,1071
848,1908,1519,602,543,88.73166,80.15979,279,"Heathcote - Waterfall",1693,73.34906,5115,61,2664,751,2451,77.2242,69.021736,401,3875,84.46115,95.76869,709,82.89032,679,41,622,254,674,1967,3212,5.882353,368,697,11.233886,"128021533",69.57606,798
1767,3481,2819,894,732,85.46394,81.27273,474,"Illawong - Alfords Point",2975,73.68421,8468,178,4255,1100,4213,77.89445,71.80851,781,7100,83.59229,89.64253,1091,81.60564,978,83,1302,540,1345,3619,5794,13.050315,752,636,24.31694,"128021534",60.69142,1609
3219,6875,5670,2017,1191,87.505455,83.416046,1112,"Menai - Lucas Heights - Woronora",6016,75.95527,16539,285,8473,2418,8066,79.55662,68.79195,1680,14002,86.543,92.06278,2230,83.4595,2053,183,2445,1025,2566,7127,11686,13.59584,1490,1346,23.929472,"128021535",66.190475,2965
2316,5819,2860,1289,1170,60.371197,51.293274,549,"Fairfield - West",3513,40.069084,14479,108,7490,2513,6989,46.32329,43.122677,1406,11993,59.735523,69.63964,2220,53.13933,1546,63,928,580,1310,6174,6373,4.787234,1345,1316,9.230769,"127021516",39.04694,2193
2745,6288,5175,2184,1481,87.83397,83.518166,664,"Oyster Bay - Como - Jannali",5523,74.42623,16002,300,8233,2615,7769,79.33466,64.83233,1140,12811,83.965126,93.38645,2510,83.50636,2344,194,2043,754,2215,6523,10698,11.345029,1163,1710,20.256584,"128021536",58.245613,2638
1150,2611,1410,586,596,66.25814,58.483032,264,"Greenfield Park - Prairiewood",1730,44.52174,6511,62,3304,1002,3207,52.455357,51.865673,619,5299,62.630085,79.35829,935,59.256462,742,34,512,278,662,2688,3140,5.5194807,536,616,10.402684,"127021517",42.649433,1057
528,1370,900,331,338,84.81752,73.39246,218,"Horsley Park - Kemps Creek",1162,65.719696,3348,85,1640,451,1708,71.31537,63.250885,338,2632,79.09091,87.966805,482,78.34347,424,43,347,179,435,1262,2062,11.375662,283,378,25.147928,"127021518",64.49704,550
2180,5488,2905,1302,1308,68.13047,57.687195,571,"Smithfield - Wetherill Park",3739,46.651375,13834,158,7038,2257,6796,52.465233,46.363636,1225,11025,64.91144,76.080956,2174,60.26304,1654,76,1017,510,1356,5537,6644,5.063291,1100,1501,12.079511,"127021519",46.612244,2089
0,5,6,6,0,100.0,100.0,0,"Royal National Park",5,0.0,11,0,6,6,5,100.0,0.0,0,11,0.0,100.0,5,100.0,5,0,0,0,0,6,11,0.0,0,0,0.0,"128021537",0.0,0
2372,6302,5297,2727,1409,87.74992,82.78689,666,"Sutherland - Kirrawee",5530,73.18719,16345,213,8634,3294,7711,79.846245,65.90909,1043,12936,82.33645,92.62584,3119,83.69666,2889,196,1736,638,1762,6634,10827,9.8,968,2000,15.117105,"128021538",63.854267,2140
1877,4849,4123,1990,1315,89.58548,85.70198,629,"Engadine",4344,77.25093,12671,177,6507,2322,6164,82.033424,65.538086,925,9875,85.0028,94.47824,2137,85.741776,2019,141,1450,542,1519,5026,8467,9.520595,827,1481,13.460076,"128021607",68.0,1787
285,885,697,374,113,93.44633,73.18983,73,"Parap",827,77.89474,1992,51,994,511,998,76.25821,66.10169,109,1799,85.13932,94.48124,453,84.71373,428,23,222,78,275,914,1524,28.75,118,80,45.132744,"701011007",66.97248,323
1848,4752,3018,1364,780,75.27357,64.6752,538,"Casula",3577,57.62987,11443,133,5911,2109,5532,60.311752,46.991405,1094,9756,75.54929,83.11205,1883,67.59943,1565,97,1065,492,1341,5004,6595,10.694597,1047,907,17.051283,"127031522",49.17733,1775
2135,5644,4081,1981,1217,83.57548,73.58841,553,"Chipping Norton - Moorebank",4717,65.2459,14013,236,7152,2692,6861,69.58227,55.202312,1046,11509,80.77883,89.01734,2595,76.44452,2310,134,1393,573,1618,5865,8798,10.411811,1038,1287,19.391947,"127031523",52.86807,2003
2271,6846,5002,2439,775,84.764824,77.74944,886,"Holsworthy - Wattle Grove",5803,74.81286,15313,139,7692,3137,7621,74.2467,58.389767,1540,13583,85.92561,93.36735,2940,79.547966,2745,88,1699,776,2033,6737,10805,9.21466,1329,955,17.935484,"127031524",57.532467,2366
2588,7916,3583,1869,1246,62.354725,48.369564,607,"Liverpool",4936,41.19011,18671,119,9509,3864,9162,45.01256,38.2626,1514,15876,58.882637,70.13286,3914,53.65961,2745,71,1066,577,1465,7960,8519,4.5836024,1508,1549,9.550562,"127031598",40.092472,2488
1221,3335,1462,670,651,58.68066,46.270718,325,"Lurnea - Cartwright",1957,41.27764,8133,62,4147,1448,3986,42.962093,35.558582,797,6738,54.242928,68.71258,1336,50.74206,918,27,504,261,652,3403,3419,3.6290324,734,744,9.523809,"127031599",40.777916,1202
1813,5540,3667,1851,498,77.99639,67.976494,597,"Prestons - Edmondson Park",4321,64.80971,12479,89,6441,2723,6038,63.464867,48.550724,1271,11318,82.19249,87.618225,2326,70.57784,2038,38,1175,603,1597,5778,7988,5.7315235,1242,663,17.871487,"127031600",46.97089,1943
542,1793,788,435,258,63.74791,51.47929,140,"Warwick Farm",1143,39.11439,4035,24,1984,845,2051,46.35294,39.616615,311,3493,55.16014,72.71739,920,55.281994,669,17,212,124,310,1700,1931,5.9859157,313,284,9.302325,"127031601",45.01608,562
2368,5234,4567,1805,1256,88.93771,83.333336,677,"Gymea - Grays Point",4655,78.20946,13537,216,7047,2166,6490,81.84588,71.31931,1050,10814,85.61215,94.86125,1946,85.27834,1846,164,1852,746,1916,5580,9222,11.179277,1046,1467,17.197453,"128011529",64.47619,2238
989,2156,1855,785,539,88.497215,86.93245,311,"Loftus - Yarrawarrah",1908,75.12639,5568,87,2873,903,2695,81.14611,68.78172,453,4442,82.97872,94.93827,810,84.714096,769,56,743,271,741,2286,3763,9.540034,394,587,16.141003,"128021608",68.65342,893
628,1288,1068,320,169,88.2764,83.55091,226,"Woronora Heights",1137,78.98089,2921,49,1464,383,1457,81.71385,78.04054,338,2595,89.08795,93.75,336,84.9711,315,21,496,231,547,1307,2205,13.375796,296,157,28.994083,"128021609",66.86391,614
3021,6678,5228,2114,1613,79.350105,74.01961,775,"Ballarat - North",5299,69.18239,17716,259,9425,2856,8291,72.1004,62.663757,1373,13929,75.98647,84.83359,2644,75.57613,2243,163,2090,861,2022,7251,10527,7.4977,1374,2174,16.057037,"201011003",56.44574,2661
3057,6824,5225,2122,1310,80.36343,76.63416,666,"Bentleigh - McKinnon",5484,73.07818,17207,227,9073,2769,8134,72.65017,50.65886,1458,14016,82.980225,88.437256,2534,76.40553,2241,177,2234,692,2350,7192,10709,9.409888,1366,1881,17.328245,"208021174",45.679012,2832
2816,6970,4967,2159,1604,72.18078,69.26532,929,"Ballarat - South",5031,58.132103,18441,178,9867,3117,8574,64.13998,57.923798,1670,14714,66.367134,80.087746,2963,67.94889,2373,122,1637,1049,1551,7744,9998,5.746585,1811,2123,11.097257,"201011004",55.628742,2337
907,2212,1564,568,465,77.98373,78.02198,304,"Buninyong",1725,73.8699,5295,87,2618,728,2677,73.49624,56.592293,630,4340,82.02247,87.28323,692,75.78341,604,47,670,279,730,2128,3289,9.591837,493,490,18.709677,"201011005",48.253967,890
856,2089,1614,682,466,80.325516,75.526024,308,"Delacombe",1678,67.64019,5371,80,2816,903,2555,71.8931,63.580246,504,4334,76.57534,85.49708,855,75.95754,731,44,579,309,559,2245,3292,7.7057796,486,571,17.167381,"201011006",61.11111,730
1334,2933,2277,863,451,82.03205,79.53917,373,"Aspendale Gardens - Waterways",2406,73.388306,6964,77,3580,1085,3384,74.85207,61.31621,717,5975,86.507935,90.58578,956,78.37657,866,53,979,382,1090,3042,4683,9.851301,623,538,17.073172,"208031183",52.022316,1260
581,1250,917,321,241,82.72,76.42857,157,"Smythes Creek",1034,74.69879,2918,42,1427,420,1491,74.55285,65.065506,260,2480,81.364395,88.946014,389,78.66936,346,13,434,149,489,1230,1951,6.5989847,229,197,17.427385,"201011007",60.384617,601
1023,1941,1275,417,992,67.903145,58.649788,220,"Maryborough (Vic.)",1318,56.69599,6215,72,3282,711,2933,60.455193,54.133335,424,4050,61.48649,76.31161,629,64.02469,480,75,580,203,546,2109,2593,6.393862,375,1173,7.2580647,"201031016",51.88679,888
793,1502,825,243,632,67.17709,60.297768,117,"Maryborough Region",1009,52.332912,4152,97,2018,403,2134,58.34512,51.83486,240,2916,57.386364,75.91623,382,62.894375,290,54,415,113,505,1414,1834,8.940397,218,604,15.348102,"201031017",48.75,880
1121,3158,2330,1126,480,80.52565,76.80764,279,"Murrumbeena",2543,75.0223,7401,97,3763,1466,3638,73.64096,50.433277,605,6322,79.96289,88.47458,1475,77.08004,1305,72,841,291,862,3164,4873,12.020034,577,599,20.208334,"208021181",46.115704,1078
1719,4267,2957,1219,1016,72.416214,68.48315,509,"Bendigo",3090,63.350784,10990,143,5707,1780,5283,66.749435,57.142857,933,8697,67.36582,78.5756,1713,69.529724,1346,117,1089,532,1092,4430,6047,9.162099,931,1277,14.074803,"202011018",54.5552,1621
1217,14957,7498,4906,442,55.860134,66.82103,1495,"Melbourne",8355,61.87346,31934,142,16535,7342,15399,46.344025,23.057743,6115,31136,77.36318,75.75956,7636,50.91534,5785,82,753,1757,933,16179,15853,23.033709,7620,356,32.126698,"206041122",24.448078,1206
1430,3269,2266,886,875,73.32517,63.42162,413,"California Gully - Eaglehawk",2397,62.65734,8757,98,4613,1397,4144,63.137363,54.593174,728,6858,68.60656,79.40954,1321,67.99358,1049,68,896,416,837,3589,4663,6.640625,762,1024,11.2,"202011019",56.73077,1220
1805,5983,4385,2402,953,77.90406,74.273346,461,"Carnegie",4661,71.68975,14561,155,7625,3234,6936,69.306145,43.1677,1142,12310,79.57176,85.769356,3113,73.48497,2670,133,1294,556,1375,6327,9046,10.246533,1288,1298,16.264427,"208021176",40.367775,1728
1095,7349,4958,3383,433,78.3644,78.31019,696,"Southbank",5759,65.93607,15502,159,7720,4320,7782,67.94573,40.170033,1598,14646,82.27395,85.99482,4634,73.17356,3985,97,722,756,919,7297,10717,22.931442,1882,423,36.720554,"206041126",43.554443,1117
1394,2971,2437,974,688,83.20431,80.762856,318,"Newtown (Vic.)",2472,72.02296,7739,191,4080,1206,3659,75.42557,60.697308,619,6202,79.196785,88.256546,1107,79.151886,977,76,1004,383,986,3231,4909,8.951708,631,849,27.761627,"203021046",51.373184,1245
1720,4145,2959,1267,1271,76.88782,72.2761,421,"North Geelong - Bell Park",3187,63.720932,11314,148,5898,1753,5416,69.329895,60.503143,793,8413,70.758354,84.46548,1796,73.053604,1517,115,1096,481,1101,4268,6146,7.055215,795,1630,11.644375,"203021047",53.089535,1556
1782,3712,2974,1043,1264,80.11854,74.76703,579,"East Bendigo - Kennington",2974,68.4624,10768,200,5792,1395,4976,72.20199,61.78344,958,7831,75.93474,84.02182,1283,75.95454,1078,129,1220,582,1117,4119,5948,7.7106996,942,1673,15.822784,"202011020",60.43841,1471
697,1596,1261,563,361,83.270676,80.313835,171,"Chelsea Heights",1329,68.57963,4092,53,2135,701,1957,74.39528,59.59596,306,3291,81.97492,89.2638,652,78.699486,582,43,478,177,523,1695,2590,9.772727,297,440,14.68144,"208031187",55.882355,638
899,1666,1240,400,850,83.85354,74.34944,157,"Alexandra",1397,66.963295,5009,173,2493,538,2516,74.87923,62.100456,235,3322,69.07675,83.83459,532,79.37989,446,102,602,136,621,1656,2637,12.18638,219,837,20.352942,"204011054",66.80851,899
953,1560,1255,383,835,86.73077,75.84158,135,"Euroa",1353,64.00839,4913,205,2518,505,2395,75.46603,60.97561,246,3223,71.55963,88.00905,442,80.918396,389,137,610,125,624,1663,2608,16.023392,205,855,24.550898,"204011055",54.878048,872
1474,3132,2053,683,1010,63.47382,71.36886,272,"Castlemaine",1988,70.69199,8222,150,4080,957,4142,73.00854,57.480316,515,5944,64.971344,53.972153,1221,67.98452,659,109,1042,219,907,2812,4041,8.596214,381,1268,14.851485,"202021027",52.815533,1396
1432,2376,1725,472,960,80.97643,67.236465,205,"Castlemaine Region",1924,65.15363,6715,181,3379,702,3336,69.58451,51.884056,360,4855,73.616104,82.24,625,75.15963,514,141,933,179,1024,2479,3649,15.666667,345,900,18.854166,"202021028",56.944443,1391
671,1174,723,239,576,72.9983,64.769646,69,"Heathcote",857,53.502235,3493,87,1743,369,1750,60.049835,47.560974,170,2378,64.76608,80.625,320,66.44239,258,47,359,78,443,1204,1580,8.7198515,164,539,15.104167,"202021029",40.588234,684
1383,2619,2074,741,920,84.99427,74.54729,267,"Kyneton",2226,69.703545,7352,176,3813,994,3539,73.88671,57.67442,459,5426,78.84297,87.26316,950,79.24806,829,121,964,248,954,2807,4300,12.027833,430,1006,19.130434,"202021030",58.169933,1210
1005,1911,1530,550,490,85.504974,75.757576,172,"Woodend",1634,72.43781,4981,126,2580,726,2401,74.74353,52.21519,345,3958,82.56684,89.381935,631,79.93936,564,87,728,165,772,2047,3164,16.322702,316,533,25.714285,"202021031",49.855072,935
676,1298,912,295,365,81.6641,71.77615,114,"Bendigo Region - North",1060,68.19527,3294,86,1631,411,1663,69.72477,47.058823,217,2606,76.115105,85.7513,386,75.671524,331,52,461,104,529,1308,1972,16.099072,221,323,23.561644,"202031032",52.53456,695
986,1843,1181,345,853,78.89311,67.77996,125,"Loddon",1454,62.068966,5250,186,2554,509,2696,67.10227,41.509434,259,3603,67.992424,80.492424,528,73.1335,425,114,612,110,718,1760,2635,14.357682,265,794,21.805393,"202031033",48.262547,1056
713,1887,1413,685,355,86.00954,77.92947,213,"Bannockburn",1623,69.0042,4516,73,2274,879,2242,73.785904,63.46749,394,3802,84.156975,94.16149,805,79.85271,758,31,492,205,579,1915,3036,8.6350975,323,359,20.563381,"203011034",54.060913,688
966,2121,1498,585,450,84.81848,73.40025,175,"Golden Plains - South",1799,69.4617,5063,144,2492,797,2571,72.22758,49.19614,348,4195,79.55426,88.933876,741,78.59357,659,89,671,153,821,2074,3297,21.291866,311,418,32.0,"203011035",50.287357,1032
850,1730,1284,444,477,88.55492,75.5102,208,"Winchelsea",1532,71.05882,4366,160,2159,588,2207,75.75221,59.92218,348,3425,79.62529,91.666664,528,82.21898,484,82,604,154,680,1695,2816,17.672413,257,464,33.542976,"203011036",59.770115,854
1915,4361,3402,1450,944,81.38042,75.01293,566,"West Wodonga",3549,69.503914,11098,159,5793,1933,5305,71.9391,60.839954,932,9090,77.38435,87.54469,1678,76.46864,1469,85,1331,536,1355,4729,6951,7.988722,881,1064,16.84322,"204031073",60.729614,1751
2851,7366,5196,2223,1522,82.05267,72.034996,1179,"Wodonga",6044,67.064186,18134,232,9246,3086,8888,70.674644,64.45229,1786,14718,77.9083,87.62326,2941,76.36907,2577,149,1912,912,2056,7352,11240,7.866948,1415,1894,15.243101,"204031074",66.013435,2639
1568,4137,3182,1472,1091,79.81629,77.6781,560,"Belmont",3302,69.13265,11049,125,5821,1895,5228,74.62476,66.91635,890,8401,74.28571,85.59602,1812,77.18129,1551,90,1084,536,1066,4264,6484,5.780347,801,1557,11.457378,"203021037",62.92135,1435
3143,7737,4106,1677,1641,60.992634,54.061897,811,"Corio - Norlane",4719,49.02959,19519,148,10141,3102,9378,50.177197,39.267284,1963,15920,59.36323,71.01297,2853,55.43342,2026,127,1541,761,1734,8183,8825,6.4862103,1938,1958,9.018891,"203021038",41.314316,2921
714,1274,1100,345,385,89.9529,79.12844,131,"Yackandandah",1146,77.591034,3434,109,1775,436,1659,79.53724,58.3691,226,2657,83.05344,92.11196,393,84.531425,362,65,554,136,544,1383,2246,16.581633,233,392,28.311687,"204031075",57.964603,655
1742,3927,3168,1328,855,79.8574,77.07487,443,"Geelong",3136,70.03445,10148,159,5366,1723,4782,74.20942,62.93532,780,8196,76.82119,83.93403,1637,76.915565,1374,114,1220,506,1160,4269,6304,10.391978,804,1097,18.59649,"203021039",56.794872,1510
2364,5947,4843,2239,1196,81.89003,78.8658,672,"Geelong West - Hamlyn Heights",4870,71.5736,15154,155,8011,2839,7143,75.51848,65.785126,1106,12360,76.92658,88.97281,2648,78.584145,2356,116,1692,796,1687,6413,9713,7.2590737,1210,1598,12.959867,"203021040",60.759495,2193
993,2628,2453,1308,619,90.44901,82.47163,232,"Armadale",2377,70.99698,7200,216,3953,1586,3247,78.220665,56.193897,429,5764,83.01435,90.60895,1363,83.795975,1235,127,705,313,694,3136,4830,15.544676,557,817,34.894993,"206061135",54.079254,836
2587,6776,5377,2379,1662,82.821724,76.81628,994,"Grovedale",5612,69.61732,17925,200,9487,3097,8438,74.60802,69.468155,1643,13983,80.97605,89.9315,2920,78.58829,2626,139,1801,1058,1792,7207,10989,6.0964913,1523,2280,12.033694,"203021041",60.49909,2213
2790,6728,5198,1958,1559,80.61831,78.22613,920,"Highton",5424,71.75627,17155,276,8868,2503,8287,73.92974,60.989643,1786,13759,83.8558,87.36401,2390,77.20038,2088,178,2002,1060,2140,7031,10622,9.689712,1738,1837,17.703655,"203021042",51.511757,2552
2128,6168,3957,1752,1070,71.07652,76.33987,666,"Lara",4384,68.93797,13842,142,6604,2295,7238,72.779106,63.11637,1171,11605,74.3273,69.2674,2730,71.87419,1891,98,1467,640,1685,5437,8341,8.397601,1014,1167,13.271028,"203021043",56.874466,2267
1538,3598,2948,1344,1051,82.851585,78.59649,416,"Leopold",2981,69.96099,9763,112,5114,1710,4649,74.08897,62.6539,724,7577,79.675995,90.435356,1516,78.24997,1371,70,1076,458,1082,3979,5929,6.167401,731,1135,10.656518,"203021044",57.458565,1358
1996,4086,2866,1046,1282,75.47724,66.035355,526,"Newcomb - Moolap",3084,60.370743,11505,132,6137,1584,5368,64.53501,60.859467,880,8527,70.67669,81.51659,1477,69.77835,1204,91,1205,524,1222,4441,5950,5.3655663,861,1696,10.296412,"203021045",59.772728,1729
2913,8601,6419,3556,1435,79.36286,78.481575,790,"Coburg",6826,65.53381,20815,190,10779,4531,10036,71.43334,55.058365,1459,17587,76.06741,85.308586,4472,75.31131,3815,105,1909,849,2031,8986,13245,5.856107,1542,1793,13.240418,"206011108",54.146675,2670
1505,4583,3306,1694,573,79.64216,74.428825,392,"Ormond - Glen Huntly",3650,73.48837,10587,121,5431,2276,5156,71.18863,47.97219,872,9227,81.30373,86.479485,2315,75.38745,2002,92,1106,414,1135,4644,6956,11.689961,863,787,21.116928,"208021182",44.95413,1396
244,655,495,230,117,83.20611,75.409836,62,"Alawa",545,72.540985,1537,32,765,305,772,74.886536,63.392857,121,1316,80.26906,87.45981,311,79.02736,272,17,177,71,179,661,1040,16.346153,112,104,27.350428,"701021010",51.23967,223
1884,3558,2808,1007,1321,80.86003,72.03147,407,"Clifton Springs",2877,67.99363,10371,160,5492,1398,4879,71.25095,62.36722,719,7499,76.485306,87.66129,1240,75.810104,1087,109,1281,411,1223,3941,5685,7.0277243,659,1551,12.112037,"203031048",56.6064,1599
770,1336,1107,340,597,87.350296,78.52194,125,"Lorne - Anglesea",1167,73.63636,3977,117,2044,433,1933,80.21739,64.97175,195,2716,77.56498,87.31707,410,83.72607,358,85,567,115,567,1380,2274,12.801205,177,664,19.59799,"203031049",64.10256,731
3095,6494,5367,2325,1787,86.495224,79.541565,699,"Ocean Grove - Barwon Heads",5617,70.40388,17367,316,9086,2923,8281,76.160065,64.04276,1155,13541,80.388565,92.263504,2611,81.11661,2409,204,2179,659,2193,7047,10984,10.004905,1029,2039,17.683268,"203031050",60.51948,2728
1115,1709,1151,315,1159,71.97192,62.376236,158,"Portarlington",1230,56.502243,5957,133,3089,505,2868,62.418655,50.44643,286,3553,62.764885,73.37963,432,67.013794,317,93,630,113,622,1844,2381,7.4698796,224,1245,11.47541,"203031051",55.244755,991
571,860,731,203,663,89.06977,76.893936,72,"Point Lonsdale - Queenscliff",766,69.001755,3340,119,1817,264,1523,75.12847,51.449276,140,1833,75.97536,87.982834,233,81.669395,205,63,394,71,370,973,1497,7.464455,138,844,17.948717,"203031052",51.42857,487
2362,5323,4331,1961,1209,85.27146,80.0735,475,"Torquay",4539,73.66638,13501,229,6969,2449,6532,77.09149,59.727386,893,10941,81.74819,91.35914,2222,81.0712,2030,148,1740,482,1805,5618,8870,10.954848,807,1351,18.941275,"203031053",53.19149,2208
697,1276,1024,345,481,75.70533,82.14286,87,"Beechworth",966,74.03156,3550,108,1793,420,1757,80.62992,58.82353,154,2546,72.47024,63.11111,450,78.16182,284,73,516,90,487,1270,1990,13.957935,153,523,22.453222,"204031068",56.493507,672
1145,2176,1769,656,851,87.04044,81.18812,248,"Bright - Mount Beauty",1894,70.65502,6137,175,3110,808,3027,78.65718,68.58108,362,4425,76.61077,88.54626,681,82.77966,603,101,809,203,868,2249,3663,11.730546,296,861,20.564043,"204031069",68.508286,1133
509,899,734,229,248,87.54171,74.11003,92,"Chiltern - Indigo Valley",787,75.638504,2333,73,1186,309,1147,75.670105,58.55263,149,1869,79.87152,87.98586,283,81.38042,249,31,385,89,373,970,1521,14.351851,152,216,29.435484,"204031070",61.744965,467
702,1281,995,290,478,82.04528,74.74227,125,"Myrtleford",1051,72.79202,3626,92,1867,388,1759,76.12854,64.51613,216,2588,75.1073,84.42623,366,79.05719,309,54,511,140,525,1307,2046,9.642858,217,560,19.246862,"204031071",57.87037,699
891,1651,1211,350,720,87.46214,73.52941,146,"Towong",1444,68.57464,4623,223,2252,476,2371,76.888885,54.807693,280,3226,76.82119,81.50538,465,82.300064,379,136,611,114,696,1575,2655,20.088627,208,677,30.972221,"204031072",52.142857,906
1365,4610,3749,2133,677,78.76356,79.11721,403,"Brunswick West",3631,70.69597,11125,96,5838,2696,5287,75.2509,62.757874,738,9592,74.272224,84.12149,2601,76.93912,2188,73,965,578,944,4982,7380,8.528037,921,856,14.180207,"206011107",54.607044,1271
1150,2920,2479,1223,415,83.321915,84.5197,285,"Alphington - Fairfield",2433,75.82609,7056,84,3721,1447,3335,78.02959,58.793102,533,6097,82.1662,89.969604,1316,80.56421,1184,43,872,341,880,3177,4912,7.904412,580,544,20.240963,"206021110",53.47092,1071
1605,4888,4047,2143,777,83.10147,80.929,536,"Hawthorn East",4062,70.46729,12064,233,6399,2648,5665,76.02856,58.037384,1045,10211,82.71605,87.34793,2466,79.41436,2154,152,1131,621,1139,5323,8109,14.126394,1070,1076,29.98713,"207011152",51.291866,1377
2890,7668,7183,3981,1221,83.42462,85.741974,611,"Northcote",6397,76.95502,19322,178,10433,4643,8889,81.05394,62.829193,1117,16530,79.74289,89.38253,3984,82.15366,3561,143,2224,835,2047,8862,13580,9.102483,1329,1571,14.578215,"206021111",54.70009,2567
0,0,0,0,0,0.0,0.0,0,"West Melbourne",0,0.0,0,0,0,0,0,0.0,0.0,0,0,0.0,0.0,0,0.0,0,0,0,0,0,0,0,0.0,0,0,0.0,"206041127",0.0,0
1988,5767,5076,3003,953,82.01838,83.88268,493,"Thornbury",4730,71.88129,14442,98,7722,3580,6720,78.44228,61.24031,893,12238,77.7653,89.039764,3093,80.12747,2754,91,1429,553,1385,6471,9806,7.274181,903,1251,10.283316,"206021112",55.20717,1781
2050,5026,4444,2531,984,89.13649,84.70549,280,"Port Melbourne",4480,68.97561,12714,289,6704,2988,6010,79.77024,59.099438,486,10597,78.85212,91.557945,2606,84.21252,2386,184,1414,315,1525,5571,8924,16.24007,533,1133,29.369919,"206051130",57.61317,1934
1726,4753,3813,2010,665,80.11782,78.1493,435,"Ascot Vale",3808,72.47972,11289,140,5871,2572,5418,75.07383,59.53905,787,9832,75.448364,85.69604,2349,77.51221,2013,87,1251,465,1220,5079,7621,10.984848,781,792,21.052631,"206031113",55.27319,1617
3594,8743,7255,3265,1493,84.8679,80.53774,1030,"Essendon - Aberfeldie",7420,73.205345,21596,320,11360,4054,10236,76.88639,64.093956,1783,18179,84.108765,90.0274,3650,80.72501,3286,213,2631,1146,2784,9436,14675,11.070686,1788,1924,21.433355,"206031114",57.767807,3310
1215,3175,2099,910,971,74.77165,70.48799,342,"Burwood East",2374,63.95062,8509,127,4363,1291,4146,65.20659,45.441795,793,6394,78.38346,81.25948,1318,69.95621,1071,88,777,324,834,3219,4473,7.6923075,713,1144,13.0793,"207031166",43.127365,1064
905,3269,2346,1390,352,69.83787,72.207794,292,"Flemington",2283,57.90055,7697,41,4076,1925,3621,65.366394,51.119896,676,6858,64.868256,79.78842,1796,67.49781,1433,44,524,388,517,3589,4629,9.034907,759,487,11.647727,"206031115",43.195267,797
999,3768,3208,2105,361,82.112526,85.39554,287,"Kensington (Vic.)",3094,68.268265,8620,52,4491,2465,4129,79.40594,64.236115,546,7808,75.69002,89.5614,2280,80.71209,2042,51,682,370,713,4040,6302,11.308204,576,451,14.404432,"206041121",52.564102,942
1694,4509,3767,1854,868,85.02994,81.387184,484,"Moonee Ponds",3834,73.61275,11318,152,5941,2278,5377,77.670105,65.14806,819,9359,82.995705,89.56817,2061,81.21594,1846,94,1247,572,1352,4850,7601,8.615949,878,1091,17.51152,"206031116",59.09646,1629
874,6903,3285,1823,452,46.646385,62.753872,684,"Carlton",3220,55.034325,16252,97,8897,2905,7355,39.28486,19.92145,3370,15265,63.783783,70.42606,2793,42.613823,1967,68,481,913,472,8362,6505,12.71028,4583,535,21.460176,"206041117",20.296736,740
1297,7720,4929,2982,507,65.064766,75.66608,735,"North Melbourne",5023,66.383965,16611,130,8384,3941,8227,63.22473,38.467552,2112,15516,68.75945,75.80495,4286,64.14024,3249,102,861,984,909,7796,9952,17.34694,2558,588,25.641026,"206041123",34.801136,1322
369,2642,1844,805,244,62.869038,78.690125,511,"Parkville",1661,74.52574,6098,72,3212,1023,2886,63.983345,47.24832,1260,5524,78.37079,77.875244,1026,63.450397,799,60,275,704,279,2882,3505,18.181818,1490,330,29.508196,"206041124",40.555557,356
1924,4733,3884,2004,1149,88.69639,80.25631,304,"Albert Park",4198,70.16632,12118,352,6236,2497,5882,76.35149,50.0,641,9820,83.361824,88.960205,2337,82.30142,2079,197,1350,333,1463,5087,8082,17.145344,666,1149,30.635336,"206051128",47.425896,1755
1767,4968,4891,2963,516,88.14412,86.916985,309,"Elwood",4379,78.664406,11900,148,6416,3409,5484,83.86488,65.39634,535,10800,81.54981,92.48308,2807,85.833336,2596,109,1390,429,1326,5832,9270,18.664383,656,584,28.68217,"206051129",57.757008,1626
0,9,3,0,0,100.0,0.0,0,"Port Melbourne Industrial",9,0.0,12,0,3,0,9,100.0,100.0,0,12,0.0,100.0,9,100.0,9,0,0,3,0,3,12,0.0,3,0,0.0,"206051131",0.0,0
1240,3767,3012,1795,665,82.32015,81.00181,219,"South Melbourne",3101,65.32258,9238,160,4806,2216,4432,75.05607,56.37343,446,7780,70.74653,87.9207,2169,78.573265,1907,93,810,314,815,4013,6113,11.727616,557,793,24.06015,"206051132",49.103138,1152
2383,9385,7547,4751,1064,83.28183,85.46501,644,"St Kilda",7816,73.35291,20787,249,10338,5559,10449,81.58919,68.57798,1072,18635,70.17001,89.20524,5725,82.44164,5107,151,1748,897,1816,9250,15363,13.878676,1308,1088,23.402256,"206051133",60.074627,2588
1403,5849,4963,3209,543,84.835014,86.7063,479,"St Kilda East",4962,74.83963,13027,123,6635,3701,6392,83.25784,70.361725,779,11810,74.6922,90.5765,3608,84.03895,3268,101,1050,603,1092,5961,9925,14.985163,857,674,22.651934,"206051134",61.48909,1462
1581,7360,6241,4103,816,84.85054,85.00104,659,"South Yarra - East",6245,64.01012,17335,271,9159,4827,8176,77.19233,55.57543,1226,15445,75.624176,90.28621,4612,80.8417,4164,194,1012,932,1151,8085,12486,18.063314,1677,1074,33.210785,"206061137",53.75204,1522
1682,3548,3141,1375,1353,95.828636,80.2217,315,"Toorak",3400,60.04756,10701,586,5800,1714,4901,74.78571,54.353233,679,7748,84.67626,89.38472,1479,84.42178,1322,319,1010,437,1177,4200,6541,19.9375,804,1600,43.31116,"206061138",46.391754,1390
607,3128,2500,1726,301,85.32609,86.472946,249,"Abbotsford",2669,68.204285,6851,76,3422,1996,3429,81.11616,65.55324,402,6210,76.52439,88.985504,2070,83.23672,1842,46,414,314,502,3082,5169,13.529411,479,340,25.24917,"206071139",61.9403,656
827,2764,2643,1494,485,86.86686,85.76349,276,"Carlton North - Princes Hill",2401,74.848854,7027,153,3778,1742,3249,82.59375,65.45167,510,5964,82.24299,90.09967,1505,84.57411,1356,117,619,413,616,3200,5044,20.242214,631,578,31.546392,"206071140",54.117645,749
1364,3863,3725,2216,640,85.788246,87.10692,291,"Fitzroy North",3314,72.50733,9862,149,5359,2544,4503,82.19329,65.54487,510,8395,77.79661,90.01381,2173,83.84753,1956,111,989,409,918,4532,7039,13.422008,624,827,23.28125,"206071143",57.058823,1180
2751,11009,9240,6047,1236,86.3657,87.17025,898,"Richmond (Vic.)",9508,65.93966,25126,287,12881,6937,12245,81.28794,69.1483,1397,22376,75.03704,91.10243,6912,83.7862,6297,218,1814,1161,2026,11367,18748,14.398943,1679,1514,23.220064,"206071144",64.2806,2700
1100,2960,2589,1371,453,84.5946,85.52714,216,"Yarra - North",2504,79.72727,7049,126,3636,1603,3413,82.47849,56.880733,405,6099,78.81188,88.41424,1545,83.50549,1366,93,877,248,796,3139,5093,18.712275,436,497,27.81457,"206071145",53.333332,1010
1071,2379,1753,713,437,80.20177,76.25668,257,"Ashburton (Vic.)",1908,69.37442,5819,90,3003,935,2816,72.139915,55.896225,522,4809,81.84584,86.56716,871,76.12809,754,60,743,237,807,2430,3661,10.471204,424,573,20.594965,"207011146",49.233715,986
2277,4635,3450,1216,1253,78.4466,70.16734,535,"Balwyn",3636,65.30523,12777,326,6889,1733,5888,67.12062,48.141594,1246,9775,80.2795,84.00824,1457,72.49105,1224,203,1487,544,1551,5140,7086,11.606632,1130,1749,26.017557,"207011147",42.9374,1932
2890,6112,4989,1852,1606,84.40772,76.56056,706,"Camberwell",5159,70.27682,16849,392,9131,2419,7718,72.12665,52.11443,1438,13029,84.78002,89.35379,2151,77.88779,1922,268,2031,838,2139,6917,10148,12.104788,1608,2214,24.408468,"207011149",49.095966,2523
2956,6134,4425,1460,1433,78.578415,72.49255,717,"Balwyn North",4820,69.68877,15839,334,8272,2014,7567,68.19232,46.741276,1666,12623,82.31798,87.443695,1776,73.23933,1553,195,2060,710,2216,6489,9245,10.936624,1519,1783,23.307747,"207011148",43.037216,2692
3253,7424,5994,2503,1709,84.29418,79.61196,856,"Kew",6258,69.474335,19432,525,10299,3144,9133,73.45588,50.879185,1714,15584,82.89427,87.91477,2863,78.619095,2517,334,2260,897,2360,8160,12252,15.614773,1763,2139,30.719719,"207011153",49.941658,2847
2330,4985,4036,1518,1005,84.874626,79.02134,510,"Glen Iris - East",4231,75.06438,12525,266,6535,1921,5990,75.8504,53.925232,1080,10306,86.127975,91.32653,1764,80.21541,1611,192,1749,577,1844,5321,8267,15.815486,1070,1214,26.46766,"207011150",47.22222,2141
2193,7923,6313,3446,1044,79.42699,81.292755,914,"Hawthorn",6293,73.00501,18583,349,9616,4239,8967,76.09692,53.809013,1996,16219,82.89054,85.78492,4045,77.723656,3470,263,1601,1003,1560,8296,12606,19.924242,1864,1320,33.42912,"207011151",45.791584,1882
1919,4380,3484,1567,903,82.557076,78.98186,434,"Bentleigh East (North)",3616,73.99687,11035,150,5752,1984,5283,74.571915,50.325096,872,9052,83.550766,89.34097,1745,78.43571,1559,110,1420,387,1473,4672,7100,10.185185,769,1080,16.611296,"208021426",49.77064,1763
859,1929,1533,588,436,83.9295,76.66232,227,"Kew East",1619,74.50524,4913,112,2548,767,2365,75.89109,56.598984,443,3949,83.45679,89.34911,676,79.81767,604,82,640,223,676,2020,3152,15.530303,394,528,25.688074,"207011154",51.241535,810
289,718,579,256,105,86.072426,79.75078,82,"Anula",618,77.16263,1668,25,845,321,823,76.79045,59.02778,134,1472,85.30466,89.508194,305,81.31793,273,15,223,85,238,754,1197,16.483517,144,91,23.809525,"701021011",61.19403,279
2401,4729,3777,1275,1207,84.055824,76.43885,542,"Surrey Hills (West) - Canterbury",3975,69.9292,12759,329,6823,1668,5936,72.01144,51.02041,1117,9974,83.68023,89.11883,1498,77.72208,1335,223,1679,600,1769,5245,7752,14.131812,1176,1578,27.257664,"207011155",48.522827,2114
1431,3199,2312,943,1119,81.713036,75.19936,325,"Bulleen",2614,66.31726,8932,171,4614,1254,4318,71.07285,53.34507,641,6452,79.8357,86.054146,1219,76.34842,1049,117,949,303,1069,3253,4926,8.596621,568,1361,15.281502,"207021156",50.702026,1339
2550,6172,4225,1853,1968,76.40959,68.83358,528,"Doncaster",4716,61.411766,17060,307,8920,2692,8140,64.73112,45.836575,1321,12699,76.864334,82.666664,2625,70.40712,2170,217,1566,589,1711,6527,8941,9.068115,1285,2393,15.599593,"207021157",39.96972,2226
2484,4786,3624,1280,1599,82.908485,72.35726,496,"Templestowe",3968,64.57327,13456,375,7071,1769,6385,69.47853,54.620975,1041,10002,80.084946,86.10086,1626,75.904816,1400,214,1604,526,1697,5216,7592,11.536388,963,1855,23.452158,"207021159",47.646492,2119
1682,3462,2833,1162,845,86.45292,80.30408,349,"Carrum - Patterson Lakes",2993,72.413795,9010,192,4703,1447,4307,77.06747,61.42596,625,7138,83.24607,90.14515,1309,81.6195,1180,117,1218,336,1272,3676,5826,11.392406,547,1027,22.721893,"208031185",55.84,1528
1687,3700,2801,1185,1388,83.45946,75.91288,340,"Templestowe Lower",3088,66.686424,10747,235,5659,1561,5088,72.00514,51.557632,737,7590,81.818184,87.91209,1456,77.588936,1280,160,1125,331,1233,3890,5889,9.044658,642,1769,16.930836,"207021160",46.132973,1507
2157,6696,4302,2063,980,68.04062,66.87196,659,"Box Hill",4556,66.01762,16028,142,8352,3085,7676,61.71281,40.775013,1821,13667,75.61486,77.93523,2964,64.81306,2310,110,1424,705,1445,6971,8858,7.9652424,1729,1381,14.489796,"207031163",36.188908,1911
2164,4509,3181,1137,1230,79.33023,70.05545,474,"Doncaster East (North)",3577,65.15712,11790,241,6051,1623,5739,67.394066,51.98285,1065,9229,80.4428,86.360695,1547,73.2257,1336,149,1410,485,1526,4720,6758,11.194591,933,1331,19.593496,"207021424",44.507042,1897
1645,3933,2870,1361,1165,77.39639,69.12138,298,"Doncaster East (South)",3044,62.613983,11096,174,5998,1969,5098,65.70513,46.68435,771,8301,77.18795,84.61539,1768,71.24443,1496,127,1030,352,1076,4368,5914,7.791411,754,1630,14.935622,"207021425",38.651104,1394
2641,6505,4856,2119,1497,80.66103,74.58641,670,"Blackburn",5247,70.35214,16746,263,8744,2841,8002,71.78123,54.247856,1389,13270,80.62827,87.808586,2633,76.13414,2312,183,1858,696,2002,6765,10103,9.247094,1283,1979,17.56847,"207031161",48.23614,2483
2231,6247,4870,2380,1387,84.55258,78.31524,512,"Caulfield - North",5282,72.03048,16068,521,8434,3039,7634,72.47024,40.96552,1284,12967,83.35,87.14141,2963,78.291046,2582,289,1607,594,1667,6720,10152,16.861143,1450,1714,37.563087,"208021177",39.87539,2000
1107,4159,2408,1016,698,59.91825,65.80311,535,"Burwood",2492,66.57633,10317,77,5460,1544,4857,55.05258,33.662216,1634,8533,77.78937,72.413795,1566,57.424118,1134,75,737,580,746,4374,4900,6.9060774,1723,1086,11.031519,"207031165",32.741737,959
2306,5508,3988,1711,1105,76.41612,71.74004,500,"Box Hill North",4209,68.039894,13921,183,7308,2385,6613,68.640274,50.670242,1192,11318,78.88999,84.16014,2298,72.42445,1934,141,1569,567,1592,5810,8197,9.41255,1119,1498,16.561087,"207031164",41.94631,2018
2096,3720,3128,924,1201,88.73656,79.177376,433,"Beaumaris",3301,73.37786,10413,299,5492,1167,4921,76.70427,60.3681,811,7798,85.559006,93.75639,977,82.444214,916,174,1538,492,1653,4078,6429,12.305516,815,1414,24.89592,"208011168",53.390877,1932
2200,5071,4182,1832,1423,86.196014,81.277725,440,"Caulfield - South",4371,72.59091,13648,419,7154,2254,6494,77.501854,52.54777,1003,10467,83.024536,89.52197,2071,81.71396,1854,258,1597,495,1658,5396,8553,14.675768,942,1758,29.444836,"208021178",43.868393,1997
3383,6080,4986,1763,2014,90.0,75.4386,556,"Brighton (Vic.)",5472,66.56814,17636,661,9542,2337,8094,71.5865,49.076305,1228,13045,85.601105,90.8158,1949,80.16865,1770,360,2252,611,2485,6965,10458,13.969732,1245,2577,32.82026,"208011169",45.276875,2903
1404,3431,2998,1509,654,86.4471,83.69384,257,"Elsternwick",2966,75.07123,8748,173,4663,1803,4085,79.480385,52.743362,541,7203,81.10932,92.770355,1646,82.798836,1527,137,1054,298,1009,3772,5964,15.375982,565,891,26.452599,"208021179",47.50462,1244
2433,4657,3806,1350,1415,88.29719,78.39721,449,"Sandringham - Black Rock",4112,73.0374,12847,347,6775,1722,6072,77.21648,56.589146,907,9586,86.37977,91.5107,1496,82.599625,1369,241,1777,438,1947,4929,7918,13.055255,774,1846,24.522968,"208011173",49.50386,2254
1691,4071,3391,1739,923,85.04053,78.83046,335,"Chelsea - Bonbeach",3462,71.31875,10752,151,5758,2206,4994,76.71946,61.759083,518,8491,76.27119,89.450226,2019,80.708984,1806,123,1206,323,1170,4420,6853,9.192825,523,1338,16.359697,"208031186",64.671814,1534
2685,6547,5318,2524,1611,84.54254,78.58032,609,"Cheltenham - Highett (East)",5535,71.061455,17411,262,9253,3212,8158,76.091,64.01099,1069,13536,80.4016,89.08969,2988,80.17878,2662,187,1908,699,2002,6989,10853,8.259717,1092,2264,16.263191,"208031188",56.96913,2490
1680,3897,3258,1436,990,85.98922,78.256134,390,"Mentone",3351,74.583336,10315,183,5428,1835,4887,77.1855,61.61473,670,8118,80.9185,90.83878,1681,81.411674,1527,134,1253,435,1251,4221,6609,11.101906,706,1207,18.484848,"208031190",58.208954,1546
1059,2663,2047,942,571,82.050316,77.08675,249,"Moorabbin - Heatherton",2185,72.804535,6623,109,3389,1222,3234,75.257355,58.76993,498,5383,79.10448,88.965515,1160,78.617874,1032,76,771,258,795,2720,4232,11.360239,439,669,19.089317,"208031191",50.0,1005
1654,3801,3145,1376,805,85.97737,79.814384,356,"Edithvale - Aspendale",3268,74.244255,9627,150,5021,1724,4606,78.68401,69.789986,628,7798,82.545685,91.55107,1586,82.23904,1452,109,1228,432,1310,3997,6413,10.644531,619,1024,18.633541,"208031189",56.687897,1587
1112,3100,2037,889,815,76.16129,71.405624,353,"Bundoora - East",2361,66.81654,7883,121,3968,1245,3915,67.76447,50.53929,741,6106,77.59132,81.79792,1346,72.02751,1101,77,743,328,786,3006,4398,8.004158,649,962,14.846625,"209011196",47.638325,1013
1078,2773,2100,1035,703,83.12297,78.528076,288,"Watsonia",2305,68.64564,7156,91,3680,1318,3476,74.02185,54.42177,522,5610,82.95688,87.54894,1277,78.5205,1118,85,740,240,808,2837,4405,10.083036,441,843,12.944524,"209011204",55.172413,974
1431,3890,2952,1514,635,77.7635,75.8517,328,"Preston - West",3025,68.69322,9437,72,4912,1996,4525,72.21135,60.2118,655,7978,76.46177,84.429245,1901,74.918526,1605,57,983,398,1020,4088,5977,6.9174757,661,824,11.338583,"209021429",50.076336,1334
605,1621,1081,531,262,64.15793,60.340908,158,"Manoora",1040,59.173553,3987,41,2104,880,1883,59.59206,46.200607,332,3435,58.990536,71.29771,655,61.746723,467,40,358,152,374,1814,2121,13.793103,329,290,15.648855,"306021151",47.590363,634
2723,6060,5003,2204,1211,85.19802,81.62963,611,"Mordialloc - Parkdale",5163,74.47668,15253,214,7982,2700,7271,78.00124,62.46216,1133,12474,84.09908,92.12046,2424,81.49751,2233,152,2028,619,2105,6414,10166,9.693877,991,1568,17.671347,"208031193",53.927628,2503
1069,3896,2369,928,484,64.24538,62.78755,460,"Kingsbury",2503,70.06548,9093,76,4713,1478,4380,57.65393,41.677338,1306,8005,81.73077,72.064514,1550,60.86196,1117,41,749,651,850,4109,4872,6.7880793,1562,604,15.702479,"209021205",35.222054,1040
2693,8297,5319,2948,1738,73.809814,68.1146,726,"Reservoir - East",6124,56.554028,20834,166,10799,4328,10035,63.103573,52.55682,1443,16726,68.323975,80.917435,4360,68.414444,3528,108,1523,740,1704,8429,11443,4.556962,1408,2370,9.5512085,"209021207",50.31185,2494
2522,7349,4728,2513,1799,74.70404,69.55439,651,"Reservoir - West",5490,59.51626,18654,168,9506,3613,9148,65.025444,54.84155,1245,14620,69.33116,81.352684,3652,69.890564,2971,91,1501,623,1700,7271,10218,4.0715885,1136,2235,9.338521,"209021208",52.289158,2452
0,0,0,0,0,0.0,0.0,0,"Essendon Airport",0,0.0,0,0,0,0,0,0.0,0.0,0,0,0.0,0.0,0,0.0,0,0,0,0,0,0,0,0.0,0,0,0.0,"210011227",0.0,0
2353,5976,5034,2420,1370,87.4498,80.99063,593,"Malvern - Glen Iris",5226,71.10072,15718,407,8372,2988,7346,76.89018,55.14096,1177,12523,84.40412,90.76087,2760,81.92925,2505,276,1673,665,1721,6547,10260,15.123287,1206,1825,29.708029,"208041194",50.382328,2039
863,2254,1756,906,607,82.120674,79.89418,189,"Airport West",1851,70.33604,5977,61,3116,1134,2861,75.88591,63.091484,349,4568,78.31912,88.37638,1084,78.96235,958,43,607,200,643,2314,3607,5.361596,317,802,10.049423,"210011226",54.154728,821
2633,6733,4947,2045,1300,78.98411,75.12858,716,"Malvern East",5318,72.76871,16838,323,8805,2722,8033,68.47059,41.229946,1653,13958,82.335945,85.96161,2657,73.54205,2284,215,1916,771,1995,7225,10265,13.607594,1870,1580,24.846153,"208041195",43.315186,2423
3598,7100,5943,2093,1428,86.1831,81.630264,851,"Eltham",6119,75.68093,17669,377,9141,2564,8528,78.54877,63.390312,1523,14666,86.35806,89.58963,2315,82.244644,2074,237,2723,890,2817,7566,12062,15.047619,1404,1575,26.40056,"209031209",55.87656,3262
522,1106,903,330,185,84.629295,80.097084,127,"Hurstbridge",936,75.28735,2635,50,1344,412,1291,79.0718,72.11539,239,2248,85.39554,90.37433,374,81.80605,338,30,393,150,421,1142,1839,14.851485,208,202,27.027027,"209031210",53.138077,493
571,1239,842,312,200,81.355934,70.428894,114,"Kinglake",1008,69.70228,2831,44,1392,443,1439,69.47195,55.050507,203,2451,78.16092,87.58782,427,75.47939,374,23,398,109,476,1212,1850,12.777778,198,180,22.0,"209031211",56.157635,609
833,1594,1240,351,373,88.582184,78.8764,190,"Panton Hill - St Andrews",1412,73.70948,3908,129,1941,445,1967,77.59699,60.625,356,3192,86.625,91.3242,438,83.08271,400,81,614,194,693,1598,2652,23.61516,320,343,34.58445,"209031212",53.370785,800
1386,2993,2382,825,590,87.83829,77.830185,391,"Plenty - Yarrambat",2629,75.39683,7230,161,3647,1060,3583,77.665474,68.27697,653,6060,88.14199,89.56693,1016,82.689766,910,88,1045,424,1167,3067,5011,15.172414,621,580,27.288136,"209031213",59.877487,1324
1034,2110,1636,549,412,87.01422,82.18563,269,"Research - North Warrandyte",1836,72.24371,5056,129,2534,668,2522,76.37722,56.81818,479,4252,85.06429,93.22581,620,81.65569,578,90,747,250,860,2142,3472,22.959183,440,392,31.31068,"209031214",56.158665,1011
1739,7542,5494,3605,903,85.110054,73.60147,647,"Cranbourne East",6419,63.59977,17705,98,9260,4898,8445,68.5807,52.328968,1262,15553,82.89551,93.146484,4567,76.59615,4254,64,1106,719,1420,8011,11913,5.1240993,1374,1249,10.852714,"212031301",51.26783,1713
1653,4289,3443,1661,1079,84.23875,77.76217,405,"Heidelberg - Rosanna",3613,73.92619,11323,165,5955,2136,5368,76.25692,58.12672,751,8804,80.81937,90.347694,1927,80.145386,1741,138,1222,422,1302,4515,7056,9.583333,726,1440,15.291937,"209011198",53.928097,1611
741,2003,1231,549,558,72.44134,68.453865,225,"Bundoora - West",1451,60.99865,5101,78,2540,802,2561,63.45361,47.858944,508,3943,74.84077,78.20069,867,68.01927,678,40,452,190,470,1940,2682,6.6666665,397,600,13.978495,"209041217",44.29134,628
2337,6910,3554,1886,1764,68.104195,59.029736,610,"Lalor",4706,43.38896,17493,139,8819,3195,8674,52.21096,46.117645,1332,13717,60.950325,78.02636,3263,60.217247,2546,66,1014,588,1411,6807,8260,3.280318,1275,2012,7.8798184,"209041219",45.795795,2315
1532,4331,2780,1449,749,71.64627,68.77077,338,"Heidelberg West",3103,58.81201,10536,99,5456,2107,5080,62.76812,45.6962,790,8760,67.043846,80.77104,2127,67.15753,1718,69,901,361,948,4429,5883,6.718598,790,1027,13.217624,"209011199",42.78481,1414
1651,3599,3018,1272,702,83.02306,80.35376,334,"Ivanhoe",2988,71.89582,9131,183,4830,1583,4301,76.21212,58.12672,677,7559,80.58985,88.52459,1464,79.454956,1296,137,1187,422,1175,3960,6006,15.747127,726,870,26.068377,"209011200",49.335304,1458
2654,5541,4175,1501,1389,80.40065,73.61452,653,"Wantirna South",4455,68.34966,14771,254,7841,2039,6930,70.60714,57.95082,1290,11454,81.385284,85.93508,1941,75.34486,1668,153,1814,707,1880,5913,8630,7.9356847,1220,1928,18.286537,"211011260",50.620155,2310
1168,2271,1852,607,654,90.04844,78.72892,258,"Ivanhoe East - Eaglemont",2045,73.54452,6078,226,3153,771,2925,75.46862,55.14563,488,4725,87.593285,87.48242,711,82.47619,622,102,859,284,939,2454,3897,14.592275,515,699,34.556576,"209011201",52.86885,1072
2209,4699,4015,1750,1268,86.529045,80.94357,461,"Montmorency - Briar Hill",4066,73.5627,12663,247,6696,2162,5967,77.49469,57.037037,818,9880,82.840546,90.03523,1987,81.7915,1789,178,1625,462,1569,5181,8081,11.749175,810,1515,19.479496,"209011202",56.356968,1894
2243,5441,4156,1880,1425,84.469765,77.04918,617,"Viewbank - Yallambie",4596,70.798035,14128,224,7262,2440,6866,74.93689,60.834297,1079,10987,81.57511,90.10846,2305,79.657776,2077,163,1588,525,1678,5546,8752,9.498835,863,1716,15.719298,"209011203",57.182575,2057
1865,5330,3861,1972,1101,80.65666,72.39354,503,"Ringwood",4299,67.29223,13484,144,7053,2724,6431,70.7791,58.42956,924,10785,75.92068,87.542595,2641,75.66064,2312,128,1255,506,1340,5455,8160,8.010013,866,1598,13.07902,"211031266",54.43723,1765
2141,6622,4606,2573,976,73.82966,74.38566,573,"Preston - East",4889,62.587574,15580,106,7982,3459,7598,68.297745,54.545456,1188,13366,70.70858,81.42857,3430,71.03845,2793,69,1340,624,1417,6744,9495,5.573506,1144,1238,10.860656,"209021428",48.232323,2004
3,3,3,0,0,100.0,0.0,0,"Darwin Airport",3,100.0,6,0,3,0,3,100.0,0.0,0,6,0.0,100.0,3,100.0,3,0,3,0,0,3,6,0.0,0,0,0.0,"701011001",0.0,0
2031,4526,3647,1354,689,86.102516,81.76328,655,"Wattle Glen - Diamond Creek",3897,76.0709,10644,155,5429,1656,5215,78.497635,67.67466,1077,9172,87.82929,91.55383,1551,82.25033,1420,99,1545,649,1667,4646,7544,12.643678,959,783,22.496372,"209031215",60.817085,1898
1600,4224,2620,1170,658,76.32576,63.004845,455,"Epping - East",3224,59.375,9988,72,5106,1857,4882,60.704357,53.899883,872,8540,76.486305,83.66577,1855,68.430916,1552,37,950,463,1145,4316,5844,4.683544,859,790,10.942249,"209041431",52.178898,1497
1043,2655,1575,747,528,74.048965,61.633663,279,"Epping - South",1966,54.650047,6450,68,3267,1212,3183,57.94702,47.516197,548,5373,72.81768,79.86689,1202,65.903595,960,38,570,220,659,2718,3541,6.9216757,463,549,12.878788,"209041432",50.912407,905
1643,3297,2532,880,1223,83.6518,72.19032,403,"Vermont South",2758,65.003044,9600,237,5080,1219,4520,69.0671,54.47761,801,6963,81.9788,88.62164,1081,75.973,958,146,1068,438,1160,3666,5290,10.325318,804,1414,19.378578,"211041273",50.31211,1415
781,2546,1644,770,326,68.06756,68.62745,261,"Bundoora - North",1733,65.81306,5911,37,3039,1122,2872,62.533283,45.592285,680,5175,76.666664,77.07182,1086,65.256035,837,29,514,331,598,2629,3377,7.0731707,726,410,11.349693,"209041216",38.382355,780
877,3444,2264,1451,198,78.48432,67.70882,273,"Epping - West",2703,58.836945,7458,43,3816,2143,3642,62.923847,50.0,571,7042,73.26139,87.10152,2039,70.533936,1776,8,516,289,611,3598,4967,3.6697247,578,218,21.717173,"209041433",47.81086,834
1382,5022,3707,2324,406,83.21386,72.7159,452,"Mernda",4179,65.55717,11298,83,5870,3196,5428,68.73725,53.742332,836,10415,78.78049,90.49391,2956,75.71771,2675,39,906,438,969,5393,7886,8.176101,815,477,20.44335,"209041434",54.066986,1230
1211,3856,2841,1565,287,83.091286,74.03027,377,"South Morang (North)",3204,68.04294,8512,46,4369,2114,4143,69.87211,57.759785,737,7922,86.113464,91.021675,1938,76.30649,1764,24,824,428,1017,4066,6045,7.920792,741,303,16.027874,"209041435",51.153324,1181
2715,6049,4180,1567,908,78.49231,69.52085,767,"Mill Park - North",4748,65.48803,14229,126,7272,2254,6957,67.08394,59.587955,1381,12280,80.374596,85.03616,2212,72.70358,1881,83,1778,752,1974,6231,8928,7.9731026,1262,1041,13.876652,"209041220",55.539463,2456
1714,3920,2668,1067,634,76.37755,67.918526,419,"Mill Park - South",2994,64.06068,9372,98,4818,1571,4554,64.88327,53.32527,819,8032,77.50163,82.18829,1572,70.49303,1292,62,1098,441,1185,4112,5662,8.78187,827,706,15.457414,"209041221",51.15995,1529
1199,2733,1665,678,401,70.54519,62.201836,322,"Delahey",1928,53.54462,6550,44,3416,1090,3134,56.72913,49.690403,642,5668,70.37037,79.3274,1011,63.39097,802,24,642,321,760,2935,3593,4.989605,646,481,10.972569,"213011331",50.15576,1080
2309,6204,3123,1514,1814,67.32753,57.240074,567,"Thomastown",4177,45.430923,16057,139,8039,2645,8018,51.619835,44.89051,1233,12254,62.870586,75.01757,2846,59.572384,2135,68,1049,492,1336,6050,7300,3.4188035,1096,1989,7.662624,"209041223",45.9854,2125
1847,5054,3511,1628,653,83.12228,71.43484,551,"Wallan",4201,69.518135,11418,145,5711,2279,5707,69.318855,55.48456,973,10119,81.84647,89.50302,2153,76.213066,1927,78,1284,521,1578,5065,7712,12.074304,939,646,22.205206,"209041224",56.628983,1928
1042,2347,1746,668,623,83.25522,72.451195,254,"Whittlesea",1954,69.481766,6066,113,3096,922,2970,72.208435,62.77533,494,4765,82.34107,89.44315,862,77.64953,771,69,724,285,816,2418,3700,10.176991,454,678,18.138042,"209041225",51.417004,991
1944,6184,5017,2824,600,87.04722,74.74854,543,"Doreen",5383,73.66255,14290,119,7506,3778,6784,73.315796,60.3033,982,13027,86.404495,93.01578,3422,79.83419,3183,85,1432,676,1538,6843,10400,12.820513,1121,663,19.833334,"209041430",55.295315,1780
1433,3676,2771,1294,657,81.284004,73.858444,444,"South Morang (South)",2988,69.71389,9109,75,4776,1752,4333,70.56277,59.433964,809,7603,82.20473,89.229805,1597,75.746414,1425,37,999,441,1044,3927,5759,4.3580685,742,849,11.415525,"209041436",54.882572,1270
608,2848,1834,1309,183,82.3736,69.29592,216,"Wollert",2346,51.80921,6143,41,3112,1889,3031,62.38095,44.469524,408,5788,72.172356,89.59108,1883,72.21838,1687,13,315,197,402,2940,4180,7.5581393,443,172,22.404371,"209041437",52.941177,557
1134,2449,1836,688,859,85.95345,76.10619,307,"Keilor",2105,70.10582,6759,152,3451,904,3308,73.64621,57.142857,540,4942,84.20533,88.50446,896,79.74504,793,93,795,260,853,2493,3941,9.707725,455,958,17.694994,"210011228",56.851852,1013
3132,7307,5356,2385,2586,81.2098,74.92931,699,"Keilor East",5934,65.54917,20581,330,10688,3183,9893,71.128815,58.024693,1416,14837,79.190544,86.93127,3099,76.09355,2694,213,2053,705,2211,7530,11290,6.7447753,1215,3158,12.761021,"210011229",49.364407,2792
914,2120,1775,776,408,84.0566,80.74922,237,"Niddrie - Essendon West",1782,75.60175,5372,65,2844,961,2528,78.57459,66.40625,420,4379,83.671036,90.36005,861,81.22859,778,53,691,255,702,2259,3557,9.059829,384,585,15.931373,"210011230",56.42857,839
1303,2913,2286,892,595,85.75352,82.28783,359,"Strathmore",2498,73.82962,7214,128,3706,1084,3508,76.48043,58.637875,637,5902,85.70294,91.64208,1017,81.05727,932,79,962,353,1079,2989,4784,11.018131,602,717,21.512606,"210011231",56.35793,1259
1673,3683,2948,1217,849,87.836006,79.077324,428,"Gisborne",3235,72.86312,9366,159,4834,1539,4532,75.589745,59.738373,743,7583,87.563774,92.93003,1372,81.53765,1275,101,1219,411,1373,3900,6183,10.813704,688,934,18.727915,"210021232",57.604305,1568
2290,6296,3805,1699,962,76.81068,62.57827,721,"Cranbourne",4836,60.131004,14624,144,7366,2715,7258,61.321514,50.75,1357,12501,74.899506,84.96296,2700,69.12247,2294,120,1377,609,1677,6205,8641,10.335917,1200,1161,14.968815,"212031300",53.13191,2239
510,958,727,262,301,89.039665,77.744804,78,"Macedon",853,73.13725,2498,85,1239,337,1259,74.4877,41.08527,158,1934,84.4898,89.03226,310,81.69597,276,39,373,53,414,976,1580,14.828897,129,263,28.239202,"210021233",49.36709,490
638,1191,1035,371,287,87.90932,83.74718,127,"Riddells Creek",1047,74.60815,3046,80,1568,443,1478,78.113205,63.934425,230,2516,83.931625,92.819145,376,82.7504,349,32,476,156,491,1325,2082,13.168724,244,243,27.874565,"210021234",55.217392,585
1337,2805,2037,744,676,85.204994,74.251495,295,"Romsey",2390,69.63351,6899,193,3418,1002,3481,72.72403,57.575756,535,5606,79.56909,89.93507,924,78.96896,831,96,931,266,1071,2801,4427,15.559157,462,617,28.550297,"210021235",55.140186,1346
810,2396,1656,937,453,78.38064,78.21369,206,"Coburg North",1878,61.851852,5854,50,3005,1198,2849,70.02114,51.260506,400,4761,75.56742,84.68324,1247,74.2281,1056,35,501,183,566,2365,3534,5.46875,357,640,11.037528,"210031236",51.5,749
1225,4197,1886,959,947,70.57422,53.218647,412,"Fawkner",2962,51.34694,10138,58,4994,1802,5144,50.863,39.060207,876,7905,67.449394,79.530205,2086,61.328274,1659,32,629,266,833,3708,4848,2.4883358,681,1286,6.124604,"210031237",47.031963,1235
1979,7054,4037,2284,1325,73.64616,64.72089,711,"Glenroy",5195,56.79636,16918,113,8539,3529,8379,60.561054,48.53195,1367,13720,67.843765,81.27292,3818,67.28863,3103,67,1124,562,1268,6666,9232,3.577149,1158,1873,8.528302,"210031438",52.011703,1869
2444,7438,5465,2980,1265,80.922295,76.37109,659,"Pascoe Vale",6019,68.780685,18090,140,9387,3902,8703,72.25013,57.79967,1281,15002,78.646286,88.414795,3867,76.5498,3419,100,1681,704,1801,7564,11484,5.4854636,1218,1823,11.067194,"210031239",51.444183,2290
318,858,712,369,160,84.84849,82.0,78,"Gowanbrae",728,79.874214,2146,23,1128,450,1018,80.18018,60.0,152,1746,85.37415,91.26214,412,82.47423,376,17,254,72,251,888,1440,7.0833335,120,240,14.375,"210031439",51.31579,294
1219,4321,1464,718,594,55.0567,41.454964,378,"Broadmeadows",2379,37.40771,9450,51,4535,1732,4915,38.93617,32.01483,939,8081,50.612556,62.090557,2076,47.555996,1289,31,456,259,661,3760,3843,4.0,809,775,8.585858,"210051242",40.255592,1306
1731,4666,1751,750,555,54.73639,39.411457,423,"Meadow Heights",2554,33.795494,10614,44,5393,1903,5221,36.59352,34.491745,1196,9451,57.0529,62.75239,1882,45.550735,1181,19,585,397,906,4785,4305,3.125,1151,608,7.927928,"210051247",35.367893,1588
20,28,31,7,0,82.14286,100.0,0,"Melbourne Airport",23,70.0,74,0,46,7,28,83.78378,60.0,5,65,100.0,100.0,15,83.07692,15,4,14,6,8,37,54,44.444443,10,9,0.0,"210051248",0.0,8
1530,4756,1581,756,1007,55.29857,39.29314,429,"Campbellfield - Coolaroo",2630,30.849672,11516,73,5753,1924,5763,34.701492,28.856625,1126,9312,51.3952,63.954044,2089,45.22122,1336,35,472,318,792,4556,4211,2.9239767,1102,1197,7.249255,"210051243",38.09947,1541
2404,5323,3851,1581,1383,79.353745,73.74067,578,"Gladstone Park - Westmeadows",4224,63.10316,13848,202,7142,2144,6706,68.11107,55.877033,1074,10977,76.41597,85.82339,2095,73.562904,1798,135,1517,618,1646,5654,8075,9.07258,1106,1488,14.605929,"210051245",53.817505,2154
2277,5505,3741,1499,793,81.52589,71.27912,744,"Greenvale - Bulla",4488,64.42688,12587,189,6289,2103,6298,66.74398,57.061226,1295,11110,80.70812,88.54011,2007,74.068405,1777,76,1467,699,1778,5605,8229,11.111111,1225,684,23.833544,"210051246",57.451736,2203
561,1393,1139,530,316,84.70926,76.258995,110,"Croydon South",1180,71.30125,3621,55,1912,695,1709,74.786606,61.04869,233,2916,82.20503,91.757385,643,79.52675,590,46,400,163,425,1523,2319,11.825192,267,389,17.405064,"211031452",47.2103,517
2338,6869,3177,1446,572,62.03232,48.02391,727,"Roxburgh Park - Somerton",4261,44.739094,15285,58,7844,3011,7441,44.39631,35.860542,1804,14025,64.486755,72.40468,2649,53.033867,1918,37,1046,648,1558,7156,7438,5.377907,1807,688,10.13986,"210051249",40.299335,2416
753,2022,1399,719,483,78.14046,74.12371,183,"Tullamarine",1580,61.752987,5106,67,2601,970,2505,69.18892,58.19398,347,4044,72.35543,84.57557,966,73.66469,817,41,465,174,513,2022,2979,7.0811744,299,579,13.871635,"210051250",52.73775,709
993,2775,1565,669,341,73.26126,57.081913,309,"Craigieburn - Central",2033,60.926487,6156,56,3040,1172,3116,58.00593,48.405254,633,5473,72.1703,82.527565,1179,65.74091,973,33,605,258,695,2698,3598,9.649123,533,342,16.422287,"210051441",48.815166,963
976,3606,2214,1280,174,78.618965,64.03201,374,"Craigieburn - North",2835,61.270493,7689,33,3909,1999,3780,59.837837,44.41379,749,7306,78.67347,88.27917,1877,69.10758,1657,14,598,322,771,3700,5049,6.6985645,725,209,18.965517,"210051442",49.933243,980
908,4377,2574,1784,264,77.358925,60.70092,353,"Craigieburn - West",3386,48.237885,9599,20,4958,2939,4641,56.01741,45.721924,714,8972,68.42105,86.22628,2846,66.42889,2454,10,438,342,559,4595,5960,2.7548208,748,363,7.5757575,"210051444",49.439777,817
353,1124,813,419,129,82.29537,71.86964,121,"Mickleham - Yuroke",925,66.85552,2512,32,1259,583,1253,70.146675,65.02242,212,2283,78.15385,88.245316,587,76.1279,518,13,236,145,254,1159,1738,13.0,223,100,24.806202,"210051445",57.07547,325
1386,3698,2708,1306,888,82.693344,73.206276,337,"Bayswater",3058,67.46032,9446,136,4860,1784,4586,71.15082,58.6478,654,7504,80.67823,87.95045,1776,76.83902,1562,94,935,373,1023,3806,5766,8.9184065,636,1054,15.315315,"211011251",51.529053,1268
1989,4776,3470,1520,980,81.700165,75.39683,521,"Knoxfield - Scoresby",3902,67.06888,11826,166,6070,2016,5756,70.61457,54.89549,1009,9690,79.988754,90.14085,1988,76.07843,1792,117,1334,499,1423,4914,7372,10.121107,909,1156,16.938776,"211011254",51.63528,1779
1758,5525,3153,1567,391,73.93665,60.92535,595,"Craigieburn - South",4085,55.688282,11863,52,5947,2572,5916,56.995663,46.672215,1238,11057,74.518684,84.17295,2521,65.46079,2122,46,979,561,1316,5532,7238,11.084337,1202,415,13.299232,"210051443",48.06139,1766
1047,2236,1763,568,221,86.717354,79.108635,366,"Lysterfield",1939,75.167145,5022,56,2565,718,2457,75.66524,67.25664,563,4566,89.61284,92.50814,614,81.07753,568,28,787,380,949,2330,3702,11.914893,565,235,25.339367,"211011255",65.00888,1059
1137,2602,2018,776,404,83.858574,76.60415,351,"Rowville - North",2182,73.26297,6206,67,3200,1013,3006,74.57502,64.928055,621,5308,87.68519,90.677025,901,79.12585,817,48,833,361,947,2706,4200,9.716599,556,494,16.584158,"211011257",56.52174,1080
1576,3486,2679,982,608,86.17326,76.006195,475,"Rowville - South",3004,73.47716,8328,164,4234,1292,4094,73.4375,62.179485,795,7134,85.56291,90.85521,1181,79.66078,1073,54,1158,485,1292,3648,5683,9.215017,780,586,26.973684,"211011258",59.74843,1510
1962,4216,3207,1327,1119,82.756165,75.01413,431,"Wantirna",3489,66.25892,11147,208,5812,1769,5335,71.09288,57.435898,814,8727,79.64853,88.21734,1638,76.727394,1445,132,1300,448,1405,4511,6696,10.146042,780,1301,18.588024,"211011259",52.948402,1764
2262,5127,3883,1542,775,82.66042,77.487434,674,"Rowville - Central",4238,70.29178,12146,144,6244,1990,5902,72.57944,60.65574,1173,10477,83.12912,90.39301,1832,77.51265,1656,85,1590,666,1764,5350,8121,9.50783,1098,894,18.580645,"211011256",57.459507,2122
2761,6647,5150,2354,1615,83.39101,74.70644,658,"Boronia",5543,68.598335,17305,282,9043,3151,8262,73.049644,63.620388,1132,13697,76.939026,88.53093,3104,78.06819,2748,178,1894,724,1855,7050,10693,8.931259,1138,1993,17.4613,"211011446",58.12721,2411
1746,4253,3189,1442,1036,82.22431,76.37712,415,"Ferntree Gully (North)",3497,70.103096,10915,160,5626,1888,5289,73.46233,59.83027,738,8594,78.59734,87.15744,1861,77.79846,1622,100,1224,423,1300,4341,6686,7.782101,707,1285,15.444016,"211011447",56.233063,1654
2804,5825,4783,1646,1012,86.67811,79.67086,890,"Croydon Hills - Warranwood",5049,76.81883,13998,241,7161,2066,6837,78.69365,70.778145,1428,11903,87.29708,91.412315,1933,82.60103,1767,128,2154,855,2151,6078,9832,11.819021,1208,1083,23.81423,"211031265",62.32493,2464
1995,4690,3645,1528,901,84.15778,77.44551,583,"Ferntree Gully (South) - Upper Ferntree Gully",3947,72.6817,11513,167,5922,1973,5591,74.83063,61.461796,942,9561,82.33696,88.155136,1908,79.40592,1682,112,1450,555,1515,4871,7592,10.656518,903,1051,18.534962,"211011448",61.889595,1840
2478,6168,4754,2121,1426,84.25746,75.0,655,"Ringwood East",5197,72.76029,15746,256,8152,2828,7594,74.35095,61.305145,1152,12562,80.95238,89.34823,2685,79.215096,2399,163,1803,667,1887,6394,9951,9.2719,1088,1758,17.952314,"211031267",56.85764,2331
1333,2897,2306,887,713,86.74491,78.5651,349,"Ringwood North",2513,73.5934,7423,152,3813,1129,3610,76.68773,61.46789,611,5904,85.34828,91.224686,1037,81.62263,946,103,981,335,1066,3007,4819,12.779157,545,806,21.318373,"211031268",57.119476,1249
597,1383,1070,454,241,84.96023,79.23211,143,"The Basin",1175,74.03685,3275,51,1651,573,1624,75.83274,60.580914,242,2794,82.661995,89.29825,570,80.35075,509,28,442,146,472,1411,2245,11.666667,241,240,21.161825,"211011449",59.090908,571
2265,4725,3614,1264,1322,85.164024,76.65252,586,"Donvale - Park Orchards",4024,70.59602,12592,312,6545,1649,6047,73.559944,57.357357,1120,9638,84.49721,89.97941,1457,79.24881,1311,178,1599,573,1815,4913,7638,10.906863,999,1632,23.600605,"211021261",52.32143,2148
1613,3176,2441,711,698,87.625946,78.82484,466,"Warrandyte - Wonga Park",2783,72.78363,7802,214,3928,902,3874,75.54936,61.03352,814,6407,87.50801,92.00999,801,81.53582,737,119,1174,437,1366,3231,5224,17.073172,716,697,30.659025,"211021262",57.248158,1561
1764,4439,3616,1807,955,83.12683,76.08421,411,"Croydon - East",3690,68.70748,11690,158,6296,2375,5394,73.76581,60.419395,715,9341,76.994064,88.491165,2207,78.214325,1953,136,1212,461,1168,4902,7306,9.756098,763,1394,16.544502,"211031450",57.482517,1517
1618,3747,3033,1286,1071,83.827065,74.07834,450,"Croydon - West",3141,70.889984,10522,172,5704,1736,4818,73.38495,61.8742,756,7880,78.93218,88.78505,1605,78.35025,1425,118,1147,482,1094,4133,6174,7.5111394,779,1571,16.059757,"211031451",59.52381,1386
1559,3826,2867,1251,551,85.337166,76.93727,475,"Bayswater North",3265,70.493904,8965,115,4588,1626,4377,73.55054,62.69285,768,7724,83.95317,90.66003,1606,79.388916,1456,70,1099,447,1219,3898,6132,10.144928,713,690,20.871143,"211031263",61.848957,1452
1260,3157,2273,1058,845,79.157425,73.16736,300,"Forest Hill",2499,64.36508,8477,114,4475,1446,4002,69.468216,52.650177,619,6429,76.65505,86.69065,1390,74.226166,1205,106,811,298,880,3272,4772,8.811305,566,1203,13.491124,"211041269",48.465267,1148
1964,4993,3962,1943,1035,84.73863,76.52619,470,"Mitcham (Vic.)",4231,70.9776,12612,191,6584,2539,6028,74.89603,62.64295,841,10283,81.7667,89.1031,2386,79.67519,2126,132,1394,493,1444,5290,8193,10.200928,787,1294,18.454105,"211041270",55.88585,1766
1274,3087,2325,1051,802,83.05798,75.178825,299,"Vermont",2564,70.09419,8028,137,4139,1398,3889,73.83296,60.377357,593,6236,80.500435,89.51311,1335,78.39961,1195,93,893,288,933,3149,4889,9.393939,477,990,17.082294,"211041272",50.421585,1159
1357,3676,2642,1322,769,80.63112,76.0207,345,"Nunawading",2964,68.312454,9153,110,4708,1739,4445,71.71553,55.10204,684,7360,77.69668,88.1751,1759,76.16848,1551,69,927,324,958,3684,5606,6.7382812,588,1024,14.304292,"211041271",50.438595,1233
1463,3242,2511,957,545,84.053055,77.74168,349,"Belgrave - Selby",2725,75.52973,7603,142,3816,1231,3787,76.0218,58.12808,629,6545,82.98319,88.52321,1185,80.0,1049,95,1105,354,1185,3303,5236,18.518518,609,513,26.055046,"211051274",55.484898,1428
1303,3067,2365,925,751,87.120964,76.63629,412,"Chirnside Park",2672,72.75518,7798,154,3980,1207,3818,75.34247,61.526234,659,6206,83.91194,90.87205,1227,81.16339,1115,105,948,387,991,3139,5037,12.485137,629,841,20.505993,"211051275",62.518967,1181
1900,3866,3021,1169,1155,85.59235,76.05725,456,"Healesville - Yarra Glen",3309,68.789474,10459,247,5438,1537,5021,73.04159,56.223175,709,8002,78.39644,88.02351,1361,79.105225,1198,152,1307,393,1408,4136,6330,11.674347,699,1302,21.38528,"211051276",64.31594,1796
1079,2602,2057,931,754,86.08762,76.12428,301,"Kilsyth",2240,68.952736,7149,111,3793,1223,3356,74.20635,65.74468,485,5374,79.75334,91.95804,1144,79.95906,1052,73,744,309,776,2772,4297,7.149853,470,1021,14.721485,"211051277",62.061855,973
2450,5684,4459,1823,1311,85.71429,75.83195,759,"Lilydale - Coldstream",4872,71.42857,14543,253,7548,2404,6995,74.18067,64.4771,1208,11695,83.40536,89.269196,2162,79.78623,1930,140,1750,746,1930,6011,9331,9.108653,1157,1537,19.298246,"211051278",62.831127,2314
795,1724,1282,457,425,86.94896,73.94822,212,"Monbulk - Silvan",1499,71.57233,4330,100,2181,618,2149,74.27578,65.8147,338,3450,83.074936,88.888885,612,80.608696,544,50,569,206,643,1726,2781,10.989011,313,455,23.529411,"211051279",62.721893,774
886,2005,1616,661,524,88.478806,81.50432,255,"Montrose",1774,71.670425,5259,99,2730,811,2529,77.506,64.175255,414,4090,86.4532,92.16945,779,82.885086,718,71,635,249,702,2085,3390,11.007751,388,645,18.89313,"211051280",61.594204,812
2733,6970,5307,2307,1312,84.261116,76.013176,905,"Mooroolbark",5873,71.60629,16900,260,8618,3035,8282,74.151184,63.13895,1472,14127,81.70093,88.863106,3017,79.13924,2681,166,1957,877,2027,7157,11180,11.362081,1389,1461,19.817074,"211051281",61.48098,2481
1516,2922,2364,831,784,88.50103,76.660515,271,"Mount Dandenong - Olinda",2586,73.02111,7471,239,3765,1084,3706,77.38134,63.296703,475,5977,82.0442,88.888885,999,82.81747,888,138,1107,288,1188,3055,4950,19.436619,455,710,30.484694,"211051282",57.05263,1448
1703,5435,4012,2125,778,84.25023,69.1957,674,"Pakenham - North",4579,66.23605,13106,137,6893,3071,6213,67.180176,58.013355,1055,11407,80.0,89.18261,2875,75.3134,2564,64,1128,695,1204,5972,8591,6.9489684,1198,921,17.609255,"212011291",63.886257,1505
1268,3140,2357,931,550,85.031845,75.75265,416,"Mount Evelyn",2670,76.1041,7417,108,3727,1229,3690,75.54487,64.52648,682,6260,84.176186,90.42208,1232,80.30351,1114,59,965,402,1032,3120,5027,9.719934,623,607,19.636364,"211051283",60.997066,1226
1910,4348,2762,1105,860,77.39191,65.930786,481,"Endeavour Hills - South",3365,60.732983,10445,169,5237,1676,5208,62.48869,51.19904,931,8768,75.12894,83.97129,1672,69.879105,1404,70,1160,427,1311,4420,6127,8.567931,834,817,19.651163,"212021454",51.664875,1745
1350,4812,3233,1910,363,81.50457,71.348526,386,"Lynbrook - Lyndhurst",3922,64.81481,10542,59,5367,2677,5175,65.99306,48.050457,833,9711,81.27209,90.75663,2564,73.67933,2327,29,875,419,1150,4899,7155,6.1965814,872,468,16.253443,"212031306",46.338535,1415
1093,2374,1847,713,497,86.14153,78.26564,275,"Pearcedale - Tooradin",2045,73.83349,5736,115,2865,911,2871,75.66571,63.386726,449,4815,84.23041,88.10624,866,80.830734,763,50,807,277,892,2441,3892,11.792453,437,424,23.138832,"212031308",61.247215,1059
1475,3181,2553,968,488,83.84156,78.38057,357,"Upwey - Tecoma",2667,76.40678,7482,99,3813,1235,3669,77.41055,62.92517,613,6479,83.12727,89.52221,1193,80.567986,1068,88,1127,370,1143,3298,5220,17.08738,588,515,20.286884,"211051284",58.238174,1375
1053,2366,1875,717,483,90.32122,77.346275,337,"Wandin - Seville",2137,74.45394,5793,143,2944,927,2849,75.604836,59.2,518,4846,86.45938,93.41951,851,82.78993,795,78,784,296,862,2480,4012,16.810345,500,464,29.606625,"211051285",65.057915,997
2283,4860,3328,1238,1181,80.61729,69.66798,522,"Yarra Valley",3918,65.1336,12233,229,6192,1777,6041,67.42301,50.913242,925,9796,75.381165,87.155426,1705,73.96896,1486,157,1487,446,1681,4936,7246,12.5,876,1256,19.390347,"211051286",56.432434,2230
1551,4225,3350,1551,535,87.50296,78.9313,589,"Beaconsfield - Officer",3697,73.62991,9711,129,4951,1965,4760,75.348625,63.978493,949,8671,87.27395,93.99888,1783,81.270905,1676,62,1142,595,1303,4446,7047,12.277227,930,505,24.11215,"212011287",62.06533,1493
1195,2570,1950,668,630,87.23735,76.78161,312,"Bunyip - Garfield",2242,72.217575,6434,161,3234,870,3200,75.08664,61.654137,524,5167,84.92706,88.793106,812,81.13025,721,91,863,328,1048,2597,4192,14.285714,532,637,25.555555,"212011288",59.541985,1234
2565,5644,4247,1602,1094,86.12686,78.29912,687,"Emerald - Cockatoo",4861,73.37232,13398,266,6660,2046,6738,75.663635,59.780437,1176,11257,84.39352,91.481674,1937,80.90965,1772,164,1882,599,2136,5613,9108,15.663801,1002,1047,24.314442,"212011289",58.418365,2531
906,2184,1611,639,527,88.507324,72.945206,283,"Koo Wee Rup",1933,70.0883,5465,166,2754,876,2711,73.36066,59.420288,459,4380,81.738174,90.80882,816,80.91324,741,91,635,246,743,2196,3544,16.308243,414,558,31.499052,"212011290",61.655773,909
2701,8201,5810,3064,1329,82.11194,68.853935,938,"Pakenham - South",6734,65.04998,20069,173,10539,4450,9530,66.112885,54.48992,1643,16989,79.42698,89.66625,4045,73.83601,3627,97,1757,892,1996,8788,12544,5.5396914,1637,1751,13.017306,"212011292",57.090687,2513
3146,6774,5332,1988,1712,84.16003,76.052025,891,"Berwick - North",5701,71.51939,18085,274,9599,2614,8486,73.35259,62.027832,1601,14043,85.17473,90.726494,2340,78.565834,2123,158,2250,936,2413,7269,11033,6.781116,1509,2330,16.004673,"212021293",55.652718,2833
2777,8100,5859,2879,764,83.50617,71.56351,942,"Berwick - South",6764,71.335976,18172,160,9308,4023,8864,68.9132,53.642773,1760,16602,86.39915,91.62883,3524,76.033005,3229,86,1981,913,2433,8502,12623,10.669975,1702,806,20.942408,"212021294",53.522728,2816
1080,3775,1376,701,641,64.927155,47.42896,369,"Doveton",2451,40.648148,8421,70,4005,1478,4416,43.39325,32.13703,817,6946,56.942005,74.94505,1820,55.09646,1364,39,439,197,648,3171,3827,4.676259,613,834,10.920437,"212021295",45.165237,1138
1335,3405,1980,873,640,72.59912,60.0,315,"Hallam",2472,55.50562,8276,86,4231,1455,4045,56.717274,45.363766,740,6896,72.659485,81.893005,1458,64.559166,1194,48,741,318,877,3491,4452,6.4864864,701,740,13.4375,"212021297",42.567566,1207
1166,2474,1810,557,529,85.165726,77.04011,386,"Narre Warren North",2107,69.12521,6031,141,3028,723,3003,72.71997,64.833336,649,4963,85.37445,88.55073,690,78.924034,611,58,806,389,969,2489,3917,10.760668,600,539,26.654064,"212021299",59.476116,1135
1647,3895,2428,999,691,76.097565,66.29064,416,"Endeavour Hills - North",2964,60.898605,9227,113,4641,1507,4586,62.352337,49.45946,843,7789,76.23635,83.478264,1495,69.22583,1248,60,1003,366,1187,3894,5392,8.032128,740,747,16.353111,"212021453",49.34757,1557
1806,4555,3022,1221,560,79.67069,69.61231,593,"Narre Warren - North East",3629,66.94352,10301,92,5186,1754,5115,66.184845,54.97018,1110,9121,83.81602,87.17339,1684,72.91964,1468,39,1209,553,1476,4566,6651,6.290323,1006,620,16.428572,"212021455",53.423424,1761
1630,4561,2801,1309,728,78.31616,64.48276,504,"Narre Warren - South West",3572,60.061348,10677,114,5388,2030,5289,61.628162,51.41243,949,9106,76.582664,86.04534,1985,69.986824,1708,58,979,455,1246,4545,6373,6.88019,885,843,15.659341,"212021456",53.108536,1627
1922,6397,4237,2280,566,79.756134,69.09091,729,"Cranbourne North",5102,64.308014,14079,96,7116,3300,6963,65.31525,52.332016,1361,12884,78.47905,88.94618,3103,72.48525,2760,59,1236,662,1517,6487,9339,9.379969,1265,629,16.96113,"212031302",53.563557,1933
1100,2724,2094,883,510,88.6931,78.0725,357,"Cranbourne South",2416,72.36364,6519,113,3285,1131,3234,76.200874,68.085106,507,5472,83.70636,91.90909,1100,82.41959,1011,63,796,352,935,2748,4510,11.731844,517,537,22.156862,"212031303",70.4142,1117
1296,4948,3220,1949,355,81.7502,69.23624,517,"Cranbourne West",4045,60.570988,10653,58,5350,2815,5303,64.76267,52.38095,933,9920,79.22705,89.6502,2773,73.235886,2486,35,785,451,984,4972,7265,9.259259,861,378,16.338028,"212031304",55.412647,1242
2858,8402,4446,1972,936,73.26827,56.84635,999,"Hampton Park - Lynbrook",6156,58.537437,18398,134,9060,3469,9338,55.216095,42.550724,2022,16454,74.037445,82.47394,3549,64.43418,2927,67,1673,734,2096,8052,10602,6.6468253,1725,1008,14.316239,"212031305",49.40653,2831
1657,4275,3109,1228,470,81.590645,72.192825,668,"Narre Warren South (East)",3488,73.385635,9645,88,4900,1701,4745,70.83618,59.553833,1160,8664,86.82171,88.73435,1438,76.14266,1276,51,1216,614,1456,4389,6597,9.980431,1031,511,18.723404,"212031457",57.58621,1677
1806,5372,3456,1629,490,77.14073,66.138855,608,"Narre Warren South (West)",4144,65.4485,11937,104,6075,2463,5862,62.66546,46.629215,1303,10887,82.333336,85.94094,2269,69.80803,1950,64,1182,581,1482,5515,7600,11.428572,1246,560,21.22449,"212031458",46.66155,1800
1630,3644,2453,1040,1044,78.81449,74.23269,410,"Clarinda - Oakleigh South",2872,60.981594,9504,170,4816,1401,4688,66.83923,55.08607,778,7314,74.29179,85.48831,1454,72.80558,1243,67,994,352,1049,3670,5325,5.846422,639,1146,16.283525,"212041309",52.69923,1412
1169,4348,2305,1327,825,71.389145,65.88878,460,"Clayton South",3104,53.378956,10082,88,4909,2014,5173,58.63648,39.973263,955,8279,67.62904,79.244446,2250,65.33398,1783,55,624,299,773,3931,5409,5.623722,748,978,10.666667,"212041310",48.167538,1143
2429,10754,3658,2016,1496,65.81737,47.29064,1068,"Dandenong",7078,41.292713,22578,135,10328,4263,12250,43.65676,32.542976,2304,19133,58.41477,74.92527,5687,56.112476,4261,90,1003,549,1614,8379,10736,4.6177526,1687,1949,9.024064,"212041311",46.354168,2763
2657,7100,3801,1768,1622,71.40845,62.122276,672,"Dandenong North",5070,51.975914,17388,182,8666,2846,8722,55.98763,41.290825,1481,13889,69.53376,79.39955,3131,63.87069,2486,121,1381,531,1730,6789,8871,6.446457,1286,1877,11.220716,"212041312",45.37475,2488
1425,3060,2433,892,921,88.62745,80.21583,385,"Dingley Village",2712,74.17544,8096,178,4115,1112,3981,78.5599,68.57143,614,6157,84.84849,91.5828,1093,83.56342,1001,100,1057,384,1148,3097,5145,9.823183,560,1018,19.326818,"212041313",62.703583,1353
1177,4244,2181,1252,686,74.45806,60.570877,411,"Noble Park - East",3160,50.977062,9635,82,4705,2067,4930,56.21134,44.496857,752,8124,64.77366,82.56478,2277,65.74348,1880,46,600,283,787,3880,5341,5.5757575,636,825,11.953353,"212041459",54.654255,1215
3026,8362,5457,2742,1490,76.35733,70.743034,764,"Keysborough",6385,58.757435,20100,218,10248,3876,9852,63.616226,47.97136,1772,16940,77.68456,85.54017,3610,69.90555,3088,133,1778,804,2315,8578,11842,7.9640718,1676,1670,14.630873,"212041314",43.115124,2980
912,2348,1362,643,574,72.35945,64.623116,194,"Noble Park North",1699,53.289474,5901,85,2979,995,2922,58.732212,42.961166,473,4667,69.327255,81.362724,998,65.58817,812,56,486,177,608,2319,3061,8.484848,412,660,14.808362,"212041316",41.0148,877
2199,7403,3359,1709,1385,63.94705,57.291317,746,"Springvale",4734,43.792633,17098,122,8310,2983,8788,50.70954,43.203884,1778,14027,62.188614,73.08262,3377,57.695873,2468,64,963,623,1398,6624,8093,3.7959669,1442,1686,8.808664,"212041317",41.957256,2248
1535,4076,2284,1072,733,69.602554,61.117447,399,"Springvale South",2837,50.488598,9812,95,5003,1754,4809,54.667305,41.28234,958,8254,69.15114,80.34751,1669,62.042645,1341,70,775,367,1002,4178,5121,8.484848,889,825,12.960437,"212041318",41.64927,1449
1931,5990,3091,1583,1186,68.68114,57.3343,607,"Noble Park - West",4114,47.79907,14431,146,7255,2761,7176,53.018867,44.639717,1333,11820,64.28198,77.68053,2742,60.956005,2130,77,923,508,1231,5830,7205,5.4035087,1138,1425,12.310287,"212041460",45.536385,1915
1985,5795,4076,2111,1034,76.255394,73.630974,563,"Ashwood - Chadstone",4419,64.93703,14154,155,7325,2867,6829,68.41222,49.36709,1178,11753,74.22222,83.95456,2817,72.27942,2365,130,1289,546,1336,5958,8495,9.509875,1106,1367,14.990329,"212051319",47.79287,1800
1200,8806,3458,1912,799,50.329323,58.363857,866,"Clayton",4432,56.166668,19161,81,9556,3276,9605,40.73987,20.488535,3907,17294,71.259125,71.10176,3803,45.62276,2704,50,674,822,781,8488,7890,4.681648,4012,1068,10.137672,"212051320",22.165344,1096
2694,6324,4125,1612,1890,75.98039,67.702644,616,"Glen Waverley - East",4805,63.585747,16923,294,8709,2381,8214,63.706562,43.57143,1600,12799,79.87654,85.17873,2294,69.77107,1954,190,1713,610,1941,6475,8930,8.504924,1400,2234,15.555555,"212051321",38.5,2430
2447,6088,3902,1685,1381,73.37385,67.94355,591,"Glen Waverley - West",4467,62.525543,15458,208,7989,2480,7469,62.242783,41.132637,1565,12357,77.74252,84.29003,2317,67.72679,1953,135,1530,552,1715,6269,8369,7.8488374,1342,1720,15.061549,"212051322",37.763577,2206
717,1744,1272,533,461,81.59404,74.64986,186,"West Mackay",1423,70.85077,4559,61,2354,714,2205,73.73913,60.884354,300,3469,76.7253,86.38298,705,77.688095,609,52,508,179,567,1725,2695,8.267091,294,629,13.232104,"312021358",62.0,739
1250,3230,2681,1254,545,84.365326,83.04636,380,"Tarragindi",2725,77.04,7858,105,4083,1510,3775,79.20236,62.72,667,6615,83.318855,90.72238,1412,81.72336,1281,72,963,392,959,3385,5406,10.315187,625,698,19.266054,"303041071",56.971516,1151
2050,4658,3334,1274,1291,76.83555,72.92501,483,"Mount Waverley - North",3579,69.60976,12292,210,6343,1747,5949,69.31393,48.963474,1159,9468,80.28617,85.04963,1612,73.014366,1371,137,1427,496,1515,4810,6913,8.936726,1013,1533,16.26646,"212051323",41.67386,1887
2207,5527,3919,1719,1424,79.41017,73.61884,556,"Mount Waverley - South",4389,67.51246,14417,204,7466,2335,6951,69.473495,49.863514,1242,11168,82.04755,87.14029,2224,74.39112,1938,162,1490,548,1691,5641,8308,8.876713,1099,1825,14.325843,"212051324",44.766506,2061
2238,5917,4064,1977,1545,80.36167,73.54911,523,"Mulgrave",4755,63.851654,15163,219,7701,2688,7462,68.23371,49.029125,1129,11873,80.01926,86.720764,2711,74.27777,2351,153,1429,505,1662,5956,8819,8.767908,1030,1745,14.174757,"212051325",46.32418,2077
967,2668,1890,954,558,81.634186,73.66795,259,"Algester",2178,66.184074,6531,96,3305,1295,3226,69.58763,53.303967,473,5384,78.63741,85.92927,1329,75.557205,1142,54,640,242,681,2716,4068,9.168081,454,589,17.204302,"303051072",54.75687,866
2352,6958,4721,2325,1288,76.99052,73.39015,682,"Oakleigh - Huntingdale",5357,67.517006,16803,173,8557,3168,8246,67.80123,48.71795,1473,13921,76.92308,85.59166,3262,72.394226,2792,105,1588,703,1710,6963,10078,6.587202,1443,1594,13.431677,"212051326",46.300068,2223
2736,5556,4182,1552,2128,82.61339,75.59669,591,"Wheelers Hill",4590,66.04532,16068,405,8384,2053,7684,71.0017,52.31608,1258,11446,81.062164,86.94489,1869,76.63813,1625,247,1807,576,1969,5890,8772,9.9037695,1101,2494,19.031956,"212051327",46.979332,2429
653,2738,1301,751,418,70.01461,60.90835,269,"Ardeer - Albion",1917,55.13017,5957,45,2801,1233,3156,57.363316,42.93194,508,5006,60.304287,77.43862,1507,64.28286,1167,26,360,164,436,2268,3218,4.878049,382,533,10.765551,"213011328",52.952755,723
880,2905,1953,1010,434,76.316696,69.896194,363,"Zillmere",2217,63.522728,6878,49,3539,1445,3339,67.414566,60.48951,601,5802,66.90647,84.82993,1470,71.871765,1247,38,559,346,558,2897,4170,5.919003,572,642,11.290322,"302041046",60.399334,834
1170,3211,2000,976,291,73.65307,67.68377,317,"Cairnlea",2365,58.88889,7128,48,3626,1442,3502,60.078102,44.351463,745,6540,76.44991,85.09036,1328,66.74312,1130,17,689,318,870,3329,4365,5.7239056,717,297,16.494844,"213011329",42.550335,1138
0,0,0,0,0,0.0,0.0,0,"Cape Conway",0,0.0,0,0,0,0,0,0.0,0.0,0,0,0.0,0.0,0,0.0,0,0,0,0,0,0,0,0.0,0,0,0.0,"312031360",0.0,0
1128,2371,1732,657,656,83.93083,76.041664,233,"Proserpine",1990,69.23759,6005,144,2978,864,3027,73.54565,57.575756,387,4726,77.307365,87.1731,803,78.75582,700,85,781,209,913,2355,3722,13.64366,363,623,21.95122,"312031361",60.20672,1181
1929,4204,2667,1106,998,76.022835,68.18742,483,"Keilor Downs",3196,55.469154,10543,133,5341,1622,5202,61.085663,52.63804,916,8570,74.29964,82.62454,1646,68.41307,1360,62,1070,429,1220,4366,5863,6.3589745,815,975,13.326653,"213011332",52.72926,1642
2484,8108,4865,2849,1099,74.23532,64.632484,672,"Deer Park - Derrimut",6019,51.650562,18689,117,9482,4408,9207,58.207706,45.15689,1521,16466,71.00592,84.103294,4221,66.099846,3550,71,1283,662,1680,8358,10884,6.316726,1466,1124,10.646042,"213011330",44.18146,2366
2675,3953,2621,766,3200,66.88591,65.08071,350,"Bribie Island",2644,50.317757,15072,217,7919,1177,7153,59.245026,59.44056,648,8377,57.93686,73.295456,1056,62.850662,774,169,1346,340,1303,4424,5265,4.8354793,572,3495,6.78125,"313011363",54.012344,2249
1755,4297,2138,995,896,65.41773,54.58036,385,"Kings Park (Vic.)",2811,43.646725,10533,117,5340,1823,5193,48.546776,37.893463,915,8701,61.623615,74.43053,1756,56.87852,1307,64,766,313,1002,4404,4949,6.837607,826,936,13.058036,"213011333",42.076504,1626
2050,6307,2897,1483,1319,64.40463,53.79035,651,"St Albans - North",4062,41.951218,15240,108,7614,2757,7626,47.892212,39.291466,1379,12356,56.500725,74.64148,2859,56.320816,2134,66,860,488,1169,6049,6959,4.2172523,1242,1565,8.188022,"213011334",47.208122,2069
1298,4123,2470,1374,1082,76.06112,69.640144,365,"Altona North",3136,56.24037,10672,87,5467,1973,5205,62.421024,44.606415,749,8080,70.477684,85.07391,2097,69.38119,1784,60,730,306,900,3957,5606,3.97351,686,1510,8.040666,"213021343",48.731644,1277
1277,4015,3113,1566,552,88.169365,83.07692,490,"Airlie - Whitsundays",3540,69.7729,8861,148,4294,1885,4567,80.46007,81.89533,634,7884,78.499275,90.927315,1995,84.3861,1814,77,891,579,1088,3869,6653,18.117647,707,425,26.811594,"312031359",77.28706,1386
1914,5490,2555,1252,1120,64.22587,56.294964,618,"St Albans - South",3526,41.797283,13174,75,6564,2224,6610,48.472775,40.24713,1346,10761,61.104973,73.99314,2334,56.509617,1727,47,800,456,1106,5271,6081,3.6349576,1133,1293,6.696429,"213011335",45.91382,1810
1271,3739,1927,930,697,66.14068,58.16135,370,"Sunshine North",2473,47.600315,8985,60,4549,1599,4436,52.60715,45.397224,850,7402,64.609375,75.57489,1609,59.443394,1216,32,605,360,827,3663,4400,3.6117382,793,886,8.608321,"213011337",43.52941,1280
2059,3788,2465,889,1911,73.28406,64.467,344,"Beachmere - Sandstone Point",2776,54.20107,11586,169,5887,1379,5699,60.774162,57.76699,630,7844,66.33139,79.590225,1269,66.8154,1010,103,1116,357,1253,4056,5241,5.6253414,618,1831,8.843537,"313011362",54.603176,1889
942,3421,1745,954,468,69.51184,62.721893,303,"Sunshine",2378,54.88323,7480,56,3591,1521,3889,58.26377,46.2406,617,6416,64.28571,76.060936,1838,64.26122,1398,28,517,246,621,2995,4123,4.6979866,532,596,11.965812,"213011336",49.10859,966
1424,3922,2536,1239,442,78.40388,69.063545,474,"Sydenham",3075,60.60393,8919,78,4555,1794,4364,63.100273,49.812733,902,7941,80.41795,85.87963,1728,70.65861,1484,35,863,399,1039,4019,5611,6.529851,801,536,17.647058,"213011339",52.54989,1292
1940,5818,2970,1513,1351,68.73496,60.326954,528,"Sunshine West",3999,47.113403,14340,115,7171,2508,7169,53.08311,42.807323,1211,11413,66.296295,77.40154,2717,61.061947,2103,52,914,491,1253,5595,6969,3.2994924,1147,1576,8.512213,"213011338",43.60033,1890
2876,5997,4197,1336,971,81.357346,72.96559,836,"Taylors Lakes",4879,68.49792,13970,176,7002,1831,6968,69.60199,61.526833,1473,12027,85.25018,85.80715,1846,75.46354,1584,77,1970,814,2283,6030,9076,7.9218106,1323,972,18.125643,"213011340",56.75492,2678
1625,3765,2886,1367,1013,83.32005,77.93615,296,"Altona",3137,68.184616,9957,131,5179,1754,4778,73.56615,57.90441,526,7688,77.42561,89.36799,1693,78.34287,1513,96,1108,315,1197,3923,6023,7.643312,544,1256,12.931886,"213021341",56.273766,1546
2618,6196,4121,1898,1143,77.146545,69.27007,615,"Altona Meadows",4780,60.733383,15140,139,7801,2740,7339,64.50149,53.24927,1158,12585,73.84485,85.25569,2679,70.72706,2284,84,1590,549,1742,6389,8901,5.9490085,1031,1412,12.16098,"213021342",53.108807,2359
2125,5670,4583,2457,772,84.69136,82.866776,441,"Newport",4802,75.10588,13248,117,6806,2965,6442,78.18151,59.715027,830,11532,82.60447,91.44501,2782,81.38224,2544,69,1596,461,1700,5862,9385,7.309322,772,944,15.15544,"213021344",53.13253,2058
667,1634,1120,495,188,79.253365,66.08812,152,"Seabrook",1295,67.316345,3726,25,1904,749,1822,65.84362,58.596493,303,3335,80.0,87.53541,706,72.413795,618,9,449,167,500,1701,2415,4.4334974,285,203,13.297873,"213021345",50.165016,625
2416,4688,3725,1324,1001,81.99659,76.753624,464,"Williamstown",3844,73.2202,11819,215,6130,1725,5689,74.61939,57.22679,961,9680,81.842575,89.537224,1491,78.19215,1335,145,1769,487,1830,4992,7569,12.741652,851,1138,21.478521,"213021346",48.28304,2236
1118,4099,2694,1615,473,77.23835,77.68158,350,"West Footscray - Tottenham",3166,64.13238,8896,60,4324,2079,4572,70.9134,53.322258,662,7898,71.79254,84.13174,2338,74.196,1967,41,717,321,789,3799,5860,7.8095236,602,525,12.684989,"213031351",52.87009,1099
1768,6335,3442,2036,698,68.76085,66.492485,649,"Braybrook",4356,47.34163,13993,62,6960,3062,7033,56.71445,43.179985,1410,12404,63.785046,79.45845,3213,62.866817,2553,34,837,535,1092,6069,7798,3.815937,1239,891,8.882522,"213031347",46.02837,1712
1202,6236,3706,2415,639,72.70686,75.82417,632,"Footscray",4534,57.8203,13129,70,6254,3185,6875,67.35732,48.789238,1241,11738,64.94546,81.18784,3620,70.199356,2939,52,695,544,893,5502,8240,6.9148936,1115,752,10.954617,"213031348",50.926674,1375
1374,4330,3179,1697,454,80.484985,78.601204,440,"Maribyrnong",3485,67.97671,9706,93,4922,2159,4784,71.76072,55.518394,885,8760,79.95169,88.924194,2203,76.07306,1959,50,934,498,993,4430,6664,10.162601,897,492,20.484581,"213031349",49.717514,1242
943,3102,2464,1547,334,81.94713,82.81585,237,"Seddon - Kingsville",2542,71.8982,7049,36,3613,1868,3436,77.95001,60.0,425,6263,78.833694,87.89263,1751,79.92975,1539,29,678,210,730,3161,5006,6.4159293,350,452,10.778443,"213031350",55.764706,926
1637,4816,4014,2294,601,84.11545,83.115944,357,"Yarraville",4051,76.35919,11283,92,5866,2760,5417,79.706116,62.28482,679,9852,82.02175,90.13209,2574,81.86155,2320,72,1250,398,1282,5036,8065,8.674699,639,830,15.30782,"213031352",52.57732,1563
2530,6063,4390,1877,1270,81.098465,71.69595,709,"Bacchus Marsh",4917,66.245056,15182,203,7849,2618,7333,69.36325,60.795937,1262,12392,79.08938,87.64924,2429,75.104904,2129,119,1676,718,1876,6329,9307,7.8289475,1181,1520,15.984252,"213041353",56.180664,2372
2231,6576,4818,2520,563,82.42092,74.95538,765,"Hillside",5420,66.56208,14592,106,7453,3362,7139,69.896996,59.0,1370,13469,81.65569,91.33117,3080,76.01158,2813,46,1485,767,1736,6893,10238,8.214286,1300,560,18.82771,"213041355",55.839417,2126
2261,5634,3426,1475,1124,74.440895,58.34652,611,"Melton",4194,55.727554,13899,168,7141,2528,6758,57.599194,51.1648,1139,11582,71.37529,80.17021,2350,65.79175,1884,98,1260,593,1531,5948,7620,8.214585,1159,1193,14.946619,"213041356",53.643547,2145
2470,6955,4372,2226,1107,75.54278,63.166855,682,"Melton South",5254,55.91093,16600,134,8538,3524,8062,59.8003,51.93622,1323,14266,71.46088,83.54282,3421,67.47511,2858,81,1381,684,1580,7311,9626,6.601467,1317,1227,12.104788,"213041357",51.549507,2211
1858,5228,3515,1763,680,78.72992,65.07937,634,"Melton West",4116,59.79548,12212,114,6304,2709,5908,62.267494,55.10204,1153,10873,76.84463,86.66943,2408,70.18302,2087,47,1111,594,1281,5645,7631,7.132018,1078,659,16.764706,"213041358",54.98699,1667
310,1340,311,124,133,30.597015,29.383886,77,"Rockbank - Mount Cottrell",410,38.064518,2463,11,990,422,1473,35.260773,41.333332,248,2222,47.30539,21.635883,758,32.448246,164,7,118,62,158,882,721,6.4814816,150,108,8.270677,"213041359",31.048388,334
1598,5903,4022,2443,474,80.41674,71.726364,535,"Taylors Hill",4747,63.45432,13039,60,6662,3406,6377,65.98852,49.03758,1154,11998,81.53018,90.63719,3076,73.08718,2788,30,1014,535,1364,6095,8769,5.291005,1091,567,12.658228,"213041360",46.360485,1673
576,1428,928,411,276,77.31092,65.44586,141,"Burnside",1104,60.76389,3598,24,1894,628,1704,61.66113,49.833885,298,2933,77.79784,88.19444,576,69.2806,508,17,350,150,431,1505,2032,4.37018,301,389,8.695652,"213041461",47.315437,554
2342,6103,3753,1585,1205,74.83205,60.151802,648,"Hoppers Crossing - South",4567,60.29035,14864,204,7556,2635,7308,60.231102,50.398724,1306,12334,74.39613,80.19841,2520,67.45581,2021,124,1412,632,1694,6231,8320,9.358491,1254,1325,16.92946,"213051362",49.617153,2277
482,1875,1242,752,108,79.46667,66.60762,174,"Burnside Heights",1490,61.20332,4062,15,2079,1129,1983,62.663975,49.86523,355,3857,80.645164,87.772514,1055,70.83225,926,10,295,185,375,1982,2732,10.309278,371,97,13.888889,"213041462",49.014084,465
2062,6217,4403,2355,525,80.16728,71.86451,579,"Caroline Springs",4984,67.361786,13854,100,7112,3277,6742,67.18035,50.123455,1221,12771,82.57386,88.56285,2999,73.502464,2656,50,1389,609,1649,6554,9387,8.960573,1215,558,19.047619,"213041463",47.420147,1997
734,3232,1743,1119,228,74.876236,66.21302,325,"Laverton",2420,52.861034,6640,29,3180,1690,3460,60.041336,44.050106,619,6135,68.94244,83.11897,1866,67.85656,1551,25,388,211,515,2903,4163,9.02527,479,277,12.719298,"213051363",52.50404,747
2400,10775,6822,4441,651,80.95592,65.19378,914,"Tarneit",8723,62.5,23245,99,11819,6812,11426,61.754322,45.61308,1948,21822,79.67033,90.15633,6461,71.23545,5825,44,1500,837,1885,11047,15545,5.699482,1835,772,15.207374,"213051365",46.919918,2366
1310,8342,4165,3019,304,71.90122,63.584667,509,"Truganina",5998,56.25954,15975,56,7329,4748,8646,59.338936,39.542145,1253,15361,68.534485,78.62032,5697,66.16106,4479,29,737,380,954,7019,10163,9.354838,961,310,18.421053,"213051366",40.622505,1392
1486,3475,2376,988,848,80.66187,67.997246,354,"Werribee - South",2803,63.122475,8894,157,4571,1453,4323,66.25767,57.805256,636,7061,77.691765,83.77997,1418,73.34655,1188,76,938,374,1104,3586,5179,7.715736,647,985,18.51415,"213051368",55.660378,1421
2025,7131,4732,2735,624,79.3998,65.66627,654,"Wyndham Vale",5662,62.271606,15973,118,8218,4165,7755,63.127003,50.842266,1339,14627,76.79474,88.384895,3814,71.06037,3371,72,1261,664,1519,7496,10394,9.9723,1306,722,18.910257,"213051369",48.84242,1978
1218,3968,2599,1448,243,82.88811,67.09917,355,"Point Cook - East",3289,64.53202,8481,69,4270,2158,4211,64.157,50.666668,705,8019,83.51284,90.321014,2056,73.42561,1857,23,786,342,1008,4051,5888,10.502283,675,219,28.395061,"213051464",50.35461,1207
2625,6460,4182,1596,786,78.42105,64.61539,799,"Hoppers Crossing - North",5066,65.942856,14595,132,7349,2470,7246,64.141106,54.666668,1459,12980,79.70102,85.76657,2459,71.24808,2109,76,1731,779,2026,6520,9248,9.167672,1425,829,16.793894,"213051361",54.76354,2542
2220,5372,3910,1631,1192,77.680565,71.067535,615,"Shepparton - North",4173,69.86487,13576,229,7012,2295,6564,70.14711,56.27951,1140,10946,75.352776,82.0038,2106,73.84433,1727,132,1551,596,1602,5574,8083,9.179416,1059,1438,19.211409,"216031416",53.94737,2126
2123,7228,4982,2902,579,82.4156,69.12816,549,"Point Cook - North",5957,66.17993,16080,76,8273,4198,7807,65.96928,51.340374,1176,14780,83.70636,90.67574,3818,74.01218,3462,43,1405,632,1870,7552,10939,5.963939,1231,721,13.12608,"213051465",46.683674,2234
2349,6084,3548,1587,963,72.50164,58.15317,641,"Werribee - East",4411,56.70498,14561,125,7514,2729,7047,56.246037,45.447155,1283,12392,71.86207,79.28408,2626,64.22692,2082,70,1332,559,1563,6308,7959,5.8043118,1230,1206,12.98027,"213051467",49.96103,2175
1598,3922,2639,1110,569,81.05558,68.01471,460,"Werribee - West",3179,65.206505,9099,106,4608,1632,4491,66.15693,56.126484,783,7911,80.731544,85.63433,1608,73.54317,1377,61,1042,426,1236,3989,5818,9.854604,759,619,18.629173,"213051468",58.748405,1531
592,1142,687,196,490,81.69878,64.68647,123,"Rushworth",933,61.148647,3146,112,1514,303,1632,64.62841,44.04762,200,2205,69.84127,82.69231,312,73.46939,258,55,362,74,440,1063,1620,12.195122,168,451,22.857143,"216011410",61.5,630
2450,6472,4678,2141,968,81.87577,71.36667,738,"Carrum Downs",5299,67.79592,15355,146,7915,3000,7440,69.956635,61.92401,1243,13159,81.07536,87.199165,2867,75.81883,2500,110,1661,766,1915,6687,9977,8.957655,1237,1228,15.082644,"214011370",59.372486,2362
2855,6753,4859,2082,1501,76.21798,70.05383,714,"Frankston",5147,62.732048,17330,214,9076,2972,8254,67.39251,58.857555,1257,13963,70.04236,82.78717,2899,71.66082,2400,172,1791,814,1819,7210,10006,9.217578,1383,1866,14.257162,"214011371",56.80191,2597
921,1772,1190,367,779,79.17607,68.98496,163,"Yarriambiack",1403,67.535286,5099,163,2548,532,2551,69.02552,43.542435,320,3496,70.14768,81.74603,504,74.17048,412,83,622,118,665,1724,2593,10.072816,271,824,20.924261,"215011394",50.9375,948
936,2055,1529,544,522,84.52555,78.61272,252,"Irymple",1737,74.893166,5084,112,2507,692,2577,76.83417,63.25967,447,4045,83.42189,88.15592,667,80.74165,588,55,701,229,785,1990,3266,10.638298,362,517,21.455938,"215021395",56.37584,941
648,1365,958,314,383,76.337,68.70897,143,"Merbein",1042,68.82716,3546,70,1798,457,1748,69.62209,55.35055,267,2741,73.38461,78.57143,448,72.96607,352,48,446,150,477,1376,2000,11.374408,271,422,18.276762,"215021396",53.558052,650
2185,5498,3437,1606,1462,73.299385,64.163,514,"Frankston North",4030,55.560642,14511,176,7551,2503,6960,60.414837,47.652348,1031,11187,68.69523,79.94198,2413,66.747116,1929,140,1214,477,1411,5689,7467,7.518797,1001,1862,12.038303,"214011372",49.85451,2054
130,387,236,90,59,74.16021,68.181816,39,"Berrimah",287,63.076923,861,19,415,132,446,62.59947,46.086956,106,764,81.159424,81.818184,143,68.4555,117,11,82,53,112,377,523,28.947369,115,38,32.20339,"701021012",36.792454,138
1547,3435,2510,924,1040,81.659386,73.74302,491,"Colac",2805,67.80866,9339,156,4864,1253,4475,72.52239,65.35552,712,6896,74.31059,84.31227,1345,77.07367,1134,105,1049,432,1024,3461,5315,7.483963,661,1403,15.0,"217031472",68.96067,1378
744,1544,1184,385,525,94.36529,76.388885,159,"Colac Region",1457,73.52151,3974,196,1905,504,2069,79.51646,58.091286,260,3033,80.719795,93.67589,506,87.0755,474,112,547,140,628,1489,2641,26.923077,241,416,37.333332,"217031473",61.153847,778
729,1473,1066,330,532,84.657166,71.58351,186,"Corangamite - North",1247,70.37037,4035,144,2030,461,2005,74.49336,55.601658,303,2904,75.370125,83.60656,427,79.64876,357,89,513,134,560,1431,2313,14.858097,241,599,27.067669,"217031474",61.38614,743
981,2108,1573,483,596,89.2315,75.0,258,"Corangamite - South",1881,76.35066,5328,185,2624,644,2704,78.258705,58.701298,431,4118,83.0059,89.984825,659,83.87567,593,115,749,226,845,2010,3454,18.729641,385,614,31.040268,"217031475",59.86079,1018
2535,5171,4268,1553,1584,87.23651,80.34144,653,"Frankston South",4511,73.92505,14229,274,7474,1933,6755,77.911644,64.25742,1087,10649,84.90648,91.42857,1785,82.43967,1632,192,1874,649,1952,5478,8779,9.619239,1010,1996,17.29798,"214011373",60.073597,2299
3329,7496,6147,2449,1316,87.11313,79.0,1074,"Langwarrin",6530,73.44548,18310,254,9498,3100,8812,76.29391,67.99754,1573,15553,84.954865,90.757164,2932,81.50839,2661,146,2445,1107,2541,8057,12677,10.131853,1628,1441,19.30091,"214011374",68.277176,2991
557,984,769,227,363,84.756096,74.18301,78,"Otway",834,73.24955,2698,98,1351,306,1347,78.790985,65.486725,135,1960,72.71095,86.64384,292,81.78571,253,60,408,74,405,976,1603,16.0,113,375,26.997246,"217031476",57.77778,557
868,1962,1394,492,499,89.85729,76.16099,212,"Moyne - East",1763,71.31336,4804,168,2343,646,2461,75.310646,50.14837,338,3813,81.72157,89.897514,683,82.7957,614,114,619,169,769,1851,3157,23.170732,337,492,33.667336,"217041477",62.721893,941
1348,2604,2058,737,834,88.47926,76.770836,255,"Moyne - West",2304,72.10683,7034,207,3596,960,3438,75.661766,57.281555,439,5324,81.03586,90.65934,910,81.93088,825,113,972,236,1017,2720,4362,12.899544,412,876,24.820145,"217041478",58.08656,1255
2717,5994,4821,1862,1492,83.91725,75.32362,923,"Warrnambool - North",5030,71.58631,15795,233,8309,2472,7486,74.146416,66.56512,1376,12496,80.103134,87.73461,2291,78.83323,2010,140,1945,874,1864,6502,9851,7.7476482,1313,1807,15.616622,"217041479",67.07849,2327
1675,3648,2917,1121,1039,82.42873,77.04467,510,"Warrnambool - South",3007,70.86567,9936,157,5249,1455,4687,75.3552,68.151146,769,7519,77.762985,85.112564,1377,78.78707,1172,104,1187,505,1168,3871,5924,7.5471697,741,1378,15.110683,"217041480",66.31989,1502
2019,5005,3650,1742,1146,79.56044,74.09613,407,"Seaford (Vic.)",3982,67.211494,12682,150,6531,2351,6151,71.5967,56.868134,762,10103,73.17814,87.29598,2267,75.541916,1979,137,1357,414,1446,5098,7632,9.560363,728,1433,13.089005,"214011375",53.412075,1976
1624,4184,3269,1516,488,86.30497,76.72065,441,"Skye - Sandhurst",3611,71.92118,9617,138,4945,1976,4672,73.70913,59.64072,772,8619,86.09894,91.29477,1815,79.82365,1657,87,1168,498,1375,4435,6880,17.058823,835,510,28.278688,"214011376",57.12435,1597
1585,2820,2249,775,1410,85.74468,74.51923,277,"Dromana",2418,65.1735,8806,243,4576,1040,4230,72.853905,65.800865,463,5907,76.10748,86.734695,980,79.00796,850,137,1033,304,1048,3087,4667,9.200806,462,1489,17.234043,"214021377",59.827213,1377
896,1450,1133,269,630,92.06896,72.50674,150,"Flinders",1335,69.64286,4217,194,2137,371,2080,76.81356,59.134617,262,2925,82.30501,86.32219,329,84.37607,284,117,624,123,707,1475,2468,17.673716,208,662,30.793652,"214021378",57.251907,859
2809,6561,4390,1697,1794,81.90825,69.152405,1205,"Hastings - Somers",5374,63.830544,16778,256,8423,2454,8355,68.19947,62.0954,1638,12998,74.14126,85.42024,2332,75.11925,1992,171,1793,729,1921,6437,9764,8.610271,1174,1986,14.269788,"214021379",73.56532,2591
3071,5970,5097,2011,2705,85.02512,78.58539,623,"Mornington",5076,69.16314,19076,376,10401,2559,8675,75.91599,63.099632,1087,12684,78.78903,88.96766,2257,80.20341,2008,278,2124,684,2069,6714,10173,7.540005,1084,3687,13.900185,"214021380",57.31371,2626
2589,4858,3987,1262,1597,88.719635,75.56886,567,"Mount Eliza",4310,73.85091,13507,382,7052,1670,6455,76.17501,57.53846,1068,10092,87.15481,91.28571,1400,82.21364,1278,252,1912,561,2083,5234,8297,13.861386,975,1818,23.91985,"214021381",53.08989,2390
2568,4978,4181,1541,1626,88.34873,80.01038,612,"Mount Martha",4398,73.98754,13922,271,7318,1926,6604,77.815,62.34357,1009,10351,85.70806,92.47312,1674,82.88088,1548,192,1900,548,1967,5373,8579,9.871466,879,1945,16.666666,"214021382",60.654114,2295
2269,4200,3207,1147,2353,84.42857,72.093025,400,"Point Nepean",3546,63.816658,13344,415,6791,1591,6553,72.08361,61.29032,642,8649,71.550095,84.39667,1442,78.07839,1217,251,1448,361,1514,4449,6753,10.717336,589,2342,17.637058,"214021383",62.305298,2116
356,1226,866,417,165,83.93149,79.885056,182,"Brinkin - Nakara",1029,78.08989,2636,45,1245,522,1391,79.15905,63.88889,286,2320,85.55241,85.17888,587,81.68104,500,33,278,138,302,1094,1895,21.854305,216,151,27.272728,"701021013",63.636364,353
2652,4888,3676,1366,2828,78.31424,71.44351,549,"Rosebud - McCrae",3828,59.84163,16635,290,8919,1912,7716,68.40343,61.851852,866,10262,67.84314,82.91836,1727,73.124146,1432,222,1587,501,1557,5374,7504,6.2623415,810,3545,10.254597,"214021384",63.39492,2295
987,2147,1566,639,667,74.47601,69.45652,247,"Mooroopna",1599,62.512665,5922,96,3108,920,2814,66.92308,56.35104,467,4487,68.91734,80.876976,821,70.53711,664,66,617,244,592,2340,3165,8.59375,433,768,14.392803,"216031415",52.890793,859
2627,5469,4499,1661,1219,87.675995,78.31212,797,"Somerville",4795,73.277504,13995,285,7307,2121,6688,76.2801,64.08696,1194,11367,82.96774,91.48718,1950,81.763,1784,176,1925,737,1929,5898,9294,12.491129,1150,1409,23.37982,"214021385",66.75042,2325
2623,6454,4381,1743,1679,75.62752,64.46006,726,"Shepparton - South",4881,66.26001,16789,286,8656,2704,8133,64.942184,52.642708,1377,13200,74.53061,77.76932,2627,70.166664,2043,153,1738,747,1826,6746,9262,8.010471,1419,1910,17.033949,"216031417",52.723312,2450
549,1214,927,278,309,88.96211,73.93617,130,"Shepparton Region - East",1080,81.056465,2894,116,1371,376,1523,81.67401,62.38095,245,2349,83.78378,89.655174,377,85.44061,338,73,445,131,496,1135,2007,30.932203,210,236,37.540455,"216031418",53.061226,592
1328,3076,2007,759,843,77.04811,73.83269,305,"Shepparton Region - West",2370,67.77109,7572,184,3653,1028,3919,71.29662,55.337692,548,5891,75.52498,73.06016,1147,74.29978,838,94,900,254,1043,2815,4377,11.217184,459,838,21.826809,"216031419",55.656933,1381
1334,2452,1766,516,914,84.74715,69.63563,260,"Glenelg (Vic.)",2078,68.14093,6702,231,3336,741,3366,72.555466,57.103065,431,4886,75.2193,85.45176,653,78.67376,558,136,909,205,1029,2434,3844,15.077605,359,902,25.273523,"217011420",60.324825,1368
1373,2711,2150,757,949,82.66322,76.54196,361,"Hamilton (Vic.)",2241,70.13838,7806,175,4146,989,3660,73.705864,58.73874,634,5628,79.32526,85.55917,921,78.020615,788,104,963,326,917,2917,4391,8.462164,555,1229,18.440464,"217011421",56.940063,1156
1506,3105,2071,752,957,76.45733,67.87003,334,"Portland",2374,61.35458,8266,151,4204,1108,4062,65.60025,55.43278,607,6262,71.74797,81.21331,1022,70.98371,830,94,924,301,1059,3157,4445,8.978032,543,1047,15.778475,"217011422",55.02471,1476
914,1702,1337,418,590,92.0094,76.0,133,"Southern Grampians",1566,74.39825,4591,224,2299,550,2292,79.11243,49.115044,252,3392,79.806656,89.788055,519,85.583725,466,128,680,111,743,1690,2903,21.018063,226,609,37.966103,"217011423",52.77778,931
2237,5155,4024,1687,894,83.10378,76.64698,673,"Alexandra Hills",4284,70.89852,12531,143,6482,2201,6049,74.312096,66.22313,1068,10570,80.07988,89.443375,2084,78.59981,1864,104,1586,647,1604,5415,8308,9.746954,977,1067,15.995525,"301011001",63.01498,2003
1089,2297,1869,694,466,85.37222,81.55112,314,"Belmont - Gumdale",1961,71.99265,5623,113,2860,851,2763,76.72414,66.53226,527,4733,83.944496,90.275955,761,80.92119,687,61,784,330,847,2436,3830,14.386792,496,424,24.248926,"301011002",59.582542,1009
1035,2814,1547,550,855,60.412224,73.333336,287,"Ararat",1700,65.60387,6751,99,3082,750,3669,71.09375,60.869564,477,4990,58.72757,53.465347,1111,65.07014,594,80,679,238,720,2176,3247,8.830022,391,906,11.578947,"215011386",60.167713,1226
421,840,631,214,339,93.57143,77.53623,58,"Ararat Region",786,70.30879,2256,134,1077,276,1179,79.77244,60.638298,105,1631,77.440346,86.49635,274,86.87921,237,64,296,57,357,791,1417,22.377623,94,286,39.528023,"215011387",55.238094,461
520,1028,732,232,439,84.04669,69.66967,141,"Rochester",864,68.46154,2967,83,1500,333,1467,70.317,51.595745,224,2069,76.459145,85.17242,290,77.13872,247,47,356,97,393,1041,1596,10.239652,188,459,18.906607,"216011409",62.94643,514
2018,4460,3602,1398,1354,84.23767,74.08585,594,"Horsham",3757,72.15064,12399,250,6585,1887,5814,74.57557,64.432434,920,9290,77.29994,87.66882,1703,79.21421,1493,152,1456,596,1420,4830,7359,8.660969,925,1755,18.463812,"215011388",64.565216,1837
480,1075,775,251,294,91.62791,73.17784,115,"Horsham Region",985,77.916664,2620,112,1251,343,1369,79.650566,61.333332,185,2048,83.185844,88.61539,325,85.9375,288,58,374,92,470,973,1760,20.86331,150,278,38.095238,"215011389",62.162163,565
983,1922,1307,402,783,81.685745,68.71795,194,"Nhill Region",1570,67.1414,5437,170,2732,585,2705,69.63239,51.779934,351,3799,71.8107,84.808014,599,75.73045,508,85,660,160,698,1877,2877,9.941521,309,855,21.711367,"215011390",55.270657,972
498,931,679,203,423,83.13641,73.02158,97,"St Arnaud",774,65.86346,2720,99,1366,278,1354,73.64425,61.643837,156,1853,71.88119,79.62963,270,78.41338,215,58,328,90,363,922,1453,13.063063,146,444,23.404255,"215011391",62.179485,505
1161,2270,1611,552,818,78.85462,70.05076,244,"Stawell",1790,65.28854,6323,151,3235,788,3088,69.349976,56.149734,422,4593,72.509224,79.71204,764,74.04746,609,91,758,210,786,2323,3401,9.97807,374,912,18.459658,"215011392",57.819904,1084
386,780,579,177,316,92.17949,74.36975,75,"West Wimmera",719,73.31606,2124,118,1028,238,1096,79.53297,47.115383,131,1508,76.77725,88.986786,227,86.07427,202,70,283,49,324,728,1298,23.333334,104,300,37.341774,"215011393",57.251907,422
1749,3948,3047,1272,1106,76.84904,72.35495,450,"Mildura - South",3034,64.493996,10869,150,5815,1758,5054,69.80527,59.67366,812,8313,71.30215,84.04118,1554,73.15049,1306,135,1128,512,1128,4365,6081,9.310345,858,1450,13.562387,"215021470",55.41872,1582
831,1614,1114,346,728,84.82032,71.19341,150,"Buloke",1369,68.83273,4676,169,2334,486,2342,71.685974,43.459915,286,3168,76.8614,83.2967,455,78.377525,379,93,572,103,671,1554,2483,11.923077,237,780,23.214285,"215031400",52.44755,873
929,1802,1291,402,830,88.124306,71.78571,199,"Gannawarra",1588,67.169,5210,200,2578,560,2632,72.446686,49.829353,336,3584,77.68332,87.2381,525,80.32924,458,119,624,146,731,1782,2879,14.949749,293,796,24.096386,"215031401",59.22619,941
490,983,725,231,430,80.46796,69.36937,111,"Kerang",791,71.83673,2986,65,1573,333,1413,72.86432,56.395348,191,1978,75.266525,81.11455,323,76.643074,262,45,352,97,353,995,1516,7.785467,172,578,15.116279,"215031402",58.115185,469
336,907,520,208,204,76.957,56.06469,76,"Robinvale",698,60.11905,2181,56,1070,371,1111,60.324825,50.322582,159,1769,76.98412,74.324326,370,68.85246,275,32,202,78,291,862,1218,15.384615,155,208,27.450981,"215031403",47.79874,378
1180,2959,2223,893,825,82.52788,72.6607,409,"Swan Hill",2442,73.55932,7910,125,4126,1229,3784,73.39056,62.903225,626,5988,78.61525,84.81544,1192,77.905815,1011,72,868,390,897,3029,4665,6.5633545,620,1097,15.151515,"215031404",65.335464,1141
825,1796,1193,387,525,83.29621,70.36364,197,"Swan Hill Region",1496,67.757576,4482,138,2161,550,2321,71.35168,53.535355,327,3468,75.24324,85.47794,544,77.53748,465,88,559,159,696,1672,2689,17.99591,297,489,26.285715,"215031405",60.244648,925
1946,3899,3225,1221,1326,82.021034,78.622025,504,"Echuca",3198,71.3258,11041,181,5816,1553,5225,75.84666,66.002655,802,8151,78.30409,84.64311,1387,78.80015,1174,119,1388,497,1339,4252,6423,7.6086955,753,1564,13.650075,"216011406",62.84289,1710
1375,2972,2131,796,1070,82.637955,72.76051,346,"Kyabram",2456,70.03636,8190,192,4148,1094,4042,71.72669,51.39442,637,5943,79.84849,85.12315,1015,77.18324,864,114,963,258,1054,2971,4587,9.685641,502,1177,17.943926,"216011407",54.317112,1320
542,1125,819,247,307,88.8,70.170456,135,"Lockington - Gunbower",999,75.46126,2790,97,1358,352,1432,75.20661,59.48718,212,2214,79.79798,91.84953,319,82.11382,293,47,409,116,474,1089,1818,17.472118,195,269,31.59609,"216011408",63.679245,594
739,1607,1091,406,734,79.02924,68.35017,181,"Cobram",1270,61.975643,4786,89,2445,594,2341,65.92145,54.968945,301,3262,73.18436,80.67796,590,72.37891,476,50,458,177,524,1655,2361,6.329114,322,790,12.12534,"216021411",60.13289,716
392,750,539,153,260,86.26667,68.0,88,"Moira",647,70.408165,1962,66,952,225,1010,73.03523,50.413223,151,1488,78.32513,90.67358,193,79.7043,175,49,276,61,318,738,1186,22.897196,121,214,25.384615,"216021412",58.278145,406
1660,3488,2517,870,1170,82.94151,73.417725,439,"Numurkah",2893,67.89156,9328,245,4670,1185,4658,72.34837,58.201893,718,6967,75.42476,86.09626,1122,77.65179,966,151,1127,369,1243,3479,5410,12.678421,634,1191,20.94017,"216021413",61.142063,1648
946,1832,1369,521,995,80.29476,75.947525,220,"Yarrawonga",1471,62.262157,5897,82,3070,686,2827,71.006226,65.202705,347,3760,71.52859,88.535034,628,75.53191,556,66,589,193,613,1928,2840,5.7793345,296,1142,8.241206,"216021414",63.400578,857
453,853,660,231,414,86.63541,71.51703,113,"Camperdown",739,63.79691,2677,79,1410,323,1267,71.895424,59.859154,157,1771,75.60976,82.867134,286,78.99492,237,55,289,85,310,918,1399,11.178862,142,492,19.082125,"217031471",71.974525,410
1027,2301,1970,797,465,87.52716,83.020836,331,"McDowall",2014,74.975655,5755,91,2989,960,2766,79.435486,69.77688,524,4781,86.18421,93.17919,865,83.32985,806,59,770,344,786,2480,3984,11.591355,493,509,19.569893,"302011026",63.16794,912
2027,4509,3539,1383,1032,84.38678,79.118996,580,"Birkdale",3805,71.92896,11337,154,5796,1748,5541,76.4528,68.266975,955,9138,82.88,90.3514,1679,80.3677,1517,115,1458,583,1554,4629,7344,9.854327,854,1167,14.922481,"301011003",60.732983,1875
2387,5624,4290,1770,1128,83.49929,77.56354,736,"Capalaba",4696,70.21365,13817,209,7065,2282,6752,74.505035,64.00367,1173,11382,79.633865,88.74669,2266,78.94922,2011,147,1676,697,1740,5758,8986,11.24713,1089,1307,18.528368,"301011004",62.7451,2185
527,1150,918,391,265,80.695656,79.31035,117,"Thorneside",928,69.259964,2920,34,1505,493,1415,75.68013,65.28497,199,2363,74.784485,88.295685,487,78.12103,430,36,365,126,347,1213,1846,12.328767,193,292,12.830189,"301011005",58.79397,464
1787,3620,2936,1022,756,83.64641,80.7267,495,"Wellington Point",3028,73.13934,8994,121,4618,1266,4376,77.36495,69.94609,827,7415,84.121216,89.5888,1143,80.43156,1024,88,1307,519,1388,3795,5964,10.692588,742,823,16.005291,"301011006",59.854897,1650
2260,4052,3199,1052,1498,83.687065,74.98218,540,"Cleveland",3391,66.37168,11877,246,6327,1403,5550,72.244804,66.27451,850,8480,77.714584,86.908516,1268,77.712265,1102,140,1500,507,1503,4428,6590,7.372301,765,1899,16.421896,"301021007",63.52941,1934
885,1661,1362,442,507,84.467186,78.64769,203,"Ormiston",1403,72.99435,4632,82,2464,562,2168,76.1745,63.636364,368,3449,84.07079,90.239044,502,80.16817,453,57,646,217,665,1788,2765,8.431952,341,676,16.17357,"301021008",55.163044,791
2008,4604,3591,1490,1040,83.514336,77.56377,559,"Redland Bay",3845,70.41833,11513,146,5869,1921,5644,74.78134,66.55212,934,9406,81.922676,89.52164,1756,79.05592,1572,106,1414,581,1568,4802,7436,9.934396,873,1067,14.038462,"301021009",59.850105,1914
933,2520,2057,1014,352,88.531746,82.77551,269,"Sheldon - Mount Cotton",2231,76.20579,5771,83,2899,1225,2872,79.60526,66.901405,438,5104,86.819176,92.95533,1164,84.01254,1082,47,711,285,797,2584,4288,14.920635,426,315,23.579546,"301021011",61.415524,918
2013,4502,3685,1397,923,85.251,80.24124,656,"Thornlands",3838,75.80725,11205,128,5780,1741,5425,77.84115,70.0,1044,9236,86.24734,90.77118,1582,81.45301,1436,76,1526,686,1618,4734,7523,7.2657743,980,1046,13.867823,"301021012",62.83525,1876
2054,4002,3257,1140,1502,83.88306,75.69721,551,"Victoria Point",3357,70.74002,11832,170,6328,1506,5504,73.804665,66.00234,877,8415,80.44853,89.24964,1386,78.59774,1237,101,1453,563,1399,4413,6614,5.2741513,853,1915,11.318242,"301021013",62.827824,1739
1476,2294,1217,321,1353,55.754143,51.442307,124,"Redland Islands",1279,45.799458,7296,133,3649,624,3647,51.306915,40.441177,300,4666,48.55532,57.913044,575,53.493355,333,110,676,110,689,2372,2496,8.613939,272,1277,9.830008,"301021527",41.333332,1419
0,0,0,0,0,0.0,0.0,0,"Brisbane Port - Lytton",0,0.0,0,0,0,0,0,0.0,0.0,0,0,0.0,0.0,0,0.0,0,0,0,0,0,0,0,0.0,0,0,0.0,"301031014",0.0,0
1179,3007,2610,1314,466,85.00166,82.69352,296,"Wavell Heights",2556,76.505516,7376,75,3903,1589,3473,79.64602,66.40472,472,6284,80.32201,90.82569,1417,82.208786,1287,56,902,338,898,3277,5166,8.945687,509,626,16.094421,"302021034",62.711864,1118
1121,2221,1748,647,557,82.845566,77.39234,242,"Manly - Lota",1840,72.52453,5761,109,2983,836,2778,74.957115,61.333332,399,4553,77.35322,87.98398,749,78.80518,659,58,813,230,830,2332,3588,8.90937,375,651,19.56912,"301031015",60.65163,1073
1476,3296,2803,1211,733,84.40534,80.1456,395,"Manly West",2782,72.76423,8621,120,4592,1511,4029,76.29287,66.08443,657,6970,82.75352,89.20808,1288,80.12913,1149,64,1074,454,1118,3674,5585,6.971678,687,918,16.371078,"301031016",60.121765,1351
820,2077,1584,734,381,81.415504,77.019936,221,"Daisy Hill",1691,69.63415,5005,83,2547,953,2458,73.537605,58.267715,421,4231,78.589745,88.35616,876,77.40487,774,57,571,222,613,2154,3275,14.503817,381,393,21.784777,"311061329",52.49406,780
486,1388,1064,527,130,84.293945,80.70444,153,"Murarrie",1170,73.45679,3066,27,1548,653,1518,76.934204,63.52459,241,2771,80.81264,89.77273,704,80.62071,632,25,357,155,358,1383,2234,15.151515,244,165,20.76923,"301031017",63.485477,443
985,2684,2290,1199,261,88.85991,81.56463,244,"Wakerley",2385,77.56345,6124,68,3179,1470,2945,79.1019,66.13636,418,5579,88.0,94.11309,1291,83.79638,1215,36,764,291,858,2895,4675,12.676056,440,284,26.05364,"301031019",58.373207,975
1287,3456,3003,1471,435,86.08218,84.00914,399,"Camp Hill",2975,76.845375,8166,81,4275,1751,3891,80.552574,68.985504,668,7184,84.22819,93.42105,1596,83.21269,1491,67,989,476,1004,3728,5978,12.248629,690,547,18.62069,"303011047",59.730537,1192
1087,2725,2232,1048,504,84.477066,81.93902,308,"Tingalpa",2302,74.24103,6686,81,3457,1279,3229,78.26087,64.609055,501,5577,78.703705,91.69329,1252,81.29819,1148,63,807,314,765,2852,4534,10.413223,486,605,16.071428,"301031018",61.477047,972
1777,4045,3099,1299,854,81.55748,76.366844,433,"Wynnum",3299,72.20034,10207,110,5308,1701,4899,74.53102,63.67647,705,8203,77.24484,88.62314,1547,77.99586,1371,84,1283,433,1385,4158,6398,7.304348,680,1150,12.880562,"301031020",61.418438,1793
119,274,241,103,57,91.240875,79.23077,26,"Eagle Farm - Pinkenba",250,77.31092,680,15,349,130,331,78.75817,64.91228,38,580,82.64463,94.78261,115,84.655174,109,9,92,37,100,306,491,20.930233,57,43,26.31579,"302031037",68.42105,121
1751,4406,3497,1667,944,82.36496,78.63207,534,"Wynnum West - Hemmant",3629,71.10223,11193,131,5843,2120,5350,75.07514,63.27827,898,9064,79.16145,88.95288,1910,78.61871,1699,87,1245,498,1265,4658,7126,7.341772,787,1185,13.877119,"301031021",59.465477,1598
850,2298,1781,896,417,80.89643,79.7153,248,"Bald Hills",1859,68.0,5544,44,2829,1124,2715,74.86339,63.45679,433,4677,77.29988,89.49416,1028,77.82767,920,50,578,257,647,2379,3640,11.111111,405,450,10.551558,"302011022",57.274826,837
1237,4394,3543,2005,468,85.434685,82.23954,540,"Nundah",3754,71.78658,9891,86,5029,2438,4862,79.403854,75.0953,752,8856,76.72269,90.33442,2452,82.39612,2215,59,888,591,913,4462,7297,10.405643,787,567,18.376068,"302031040",71.80851,1190
1280,2490,2012,666,583,85.58233,79.66507,335,"Bridgeman Downs",2131,71.875,6436,141,3363,836,3073,75.07462,61.17021,581,5170,84.0106,90.60489,777,80.1354,704,81,920,345,951,2680,4143,11.859444,564,683,24.18525,"302011023",57.659206,1132
1085,2552,2123,960,769,85.46238,81.14962,299,"Carseldine",2181,70.87558,7207,117,3886,1183,3321,77.171936,67.49483,489,5303,79.48164,90.50132,1137,81.161606,1029,68,769,326,736,2751,4304,5.9911895,483,1135,15.214564,"302011024",61.145195,926
790,2121,1810,894,312,82.50825,79.396095,259,"Carina Heights",1750,68.6076,5241,59,2808,1126,2433,76.37131,70.92511,429,4491,77.0206,89.16117,1061,79.26965,946,52,542,322,486,2370,3560,11.872146,454,438,18.910257,"303011050",60.37296,631
921,2737,2352,1194,577,86.29887,82.458565,358,"Everton Park",2362,73.832794,6989,97,3675,1448,3314,79.864174,72.22222,527,5682,78.4689,91.048035,1374,82.963745,1251,62,680,416,656,2945,4714,8.493151,576,730,16.811092,"302011025",67.93169,836
1554,3581,2873,1185,1033,83.77548,80.121704,391,"Aspley",3000,71.42857,9755,180,5141,1479,4614,76.756615,64.366196,690,7324,79.91422,87.86863,1492,80.18842,1311,121,1110,457,1118,3743,5873,8.655222,710,1398,17.424976,"302021027",56.666668,1399
867,2780,2183,1172,541,76.76259,75.95593,315,"Chermside",2134,62.168396,7263,49,3942,1543,3321,70.62439,62.26138,509,5871,68.79433,82.05619,1566,73.530914,1285,48,539,424,485,3091,4317,5.640423,681,851,9.0573015,"302021028",61.88605,705
479,1329,1045,538,276,83.972916,85.53259,132,"Geebung",1116,70.563675,3282,40,1677,629,1605,79.58873,65.85366,222,2642,77.29258,90.90909,649,81.7941,590,34,338,135,354,1313,2161,9.340659,205,364,14.492754,"302021030",59.45946,458
1482,4504,3800,1972,534,86.96714,83.31221,573,"Kedron - Gordon Park",3917,76.11336,10477,97,5439,2367,5038,80.525536,73.21839,811,9223,82.85332,91.36364,2200,83.67126,2010,63,1128,637,1237,4719,7717,8.75,870,720,18.164795,"302021031",70.65351,1493
670,2132,1714,918,324,81.28518,79.75674,264,"Stafford",1733,67.61194,5163,44,2707,1151,2456,75.50661,69.710464,426,4402,76.27986,87.32143,1120,78.30531,978,30,453,313,447,2270,3447,6.8649883,449,437,13.580247,"302021032",61.971832,586
825,1997,1617,726,523,81.472206,80.936455,246,"Stafford Heights",1627,71.51515,5304,71,2784,897,2520,76.381676,63.291138,392,4114,76.00536,86.495926,859,78.8527,743,51,590,250,567,2117,3244,7.646177,395,667,13.575526,"302021033",62.7551,746
725,2249,1750,937,295,83.948425,84.11131,233,"Northgate - Virginia",1888,72.68965,5071,53,2527,1114,2544,79.43713,66.75824,377,4452,79.60057,89.15457,1171,81.71608,1044,43,527,243,558,2203,3638,13.271605,364,324,17.966103,"302031038",61.803715,701
1048,3075,2310,1197,512,83.414635,81.207596,348,"Nudgee - Banyo",2565,70.51527,7282,76,3695,1474,3587,75.76254,61.10057,557,6124,78.91843,89.69867,1427,79.604836,1280,52,739,322,861,3049,4875,8.049536,527,646,14.84375,"302031039",62.47756,1091
2090,5294,4074,1844,1003,81.69626,77.34899,690,"Bracken Ridge",4325,69.09091,12976,131,6679,2384,6297,73.56446,64.56767,1088,10832,78.15509,87.86386,2233,77.53877,1962,99,1444,687,1542,5538,8399,8.6765995,1064,1141,13.060818,"302041041",63.419117,1973
1320,2852,2313,1016,618,82.11781,81.15016,268,"Brighton (Qld)",2342,72.19697,7227,89,3757,1252,3470,77.513405,65.048546,436,5836,77.75194,87.211365,1126,79.763535,982,76,953,268,1003,2984,4655,9.831824,412,773,14.401295,"302041042",61.46789,1290
459,1121,854,392,266,76.71722,79.03226,95,"Deagon",860,72.331154,2830,38,1443,496,1387,74.97805,63.04348,189,2260,70.98121,85.430466,453,75.840706,387,14,332,116,340,1139,1714,4.605263,184,304,14.285714,"302041043",50.26455,479
1340,3559,2999,1569,717,82.88845,75.943855,384,"Taigum - Fitzgibbon",2950,71.04478,9455,72,5179,2066,4276,73.95808,62.09553,646,7614,78.87454,89.61181,1829,78.132385,1639,75,952,403,855,4055,5949,6.672598,649,1124,10.041841,"302041045",59.442726,1084
992,1963,1478,546,580,79.36832,77.22772,217,"Sandgate - Shorncliffe",1558,68.951614,5296,67,2753,707,2543,74.53354,71.12676,344,3946,75.3784,83.9172,628,76.938675,527,46,684,202,747,1983,3036,5.974026,284,770,11.551724,"302041044",63.081394,991
568,1831,1473,785,242,86.1278,81.685745,234,"Cannon Hill",1577,74.29578,4242,33,2169,961,2073,78.77005,70.38123,339,3701,79.81651,92.39704,947,82.41016,875,26,422,240,435,1870,3050,8.695652,341,299,13.636364,"303011048",69.02655,545
1210,3331,2890,1485,658,85.469826,83.2866,379,"Carina",2847,73.305786,8684,102,4695,1783,3989,79.09141,66.26324,617,6985,80.17159,91.59159,1665,82.13314,1525,80,887,438,841,3654,5737,7.6849184,661,1041,15.50152,"303011049",61.426254,1049
2478,4911,3902,1274,1086,84.15801,78.20749,735,"Carindale",4133,72.0339,12564,212,6567,1629,5997,74.63657,62.97948,1191,10139,83.21645,88.93105,1581,79.24844,1406,137,1785,706,1780,5228,8035,10.231516,1121,1339,19.52118,"303011051",61.712845,2139
1055,4197,3167,1673,383,76.935905,78.72941,536,"Annerley",3229,72.227486,9277,64,4697,2125,4580,75.02962,65.51393,912,8418,72.14156,84.012825,2183,75.98004,1834,50,762,682,795,4221,6396,10.504202,1041,476,16.710182,"303021052",58.77193,1102
1710,5381,4581,2432,714,85.74615,84.79777,651,"Coorparoo",4614,76.31579,12728,146,6633,2868,6095,81.65775,70.34884,990,10991,82.07841,89.72701,2784,83.659355,2498,118,1305,726,1319,5610,9195,11.534702,1032,1023,20.44818,"303021053",65.757576,1607
474,1764,1239,601,213,71.99547,75.125,260,"Fairfield - Dutton Park",1270,70.04219,3915,30,1938,800,1977,70.75957,61.215935,489,3515,74.4186,78.30424,802,71.3798,628,14,332,292,352,1751,2509,7.486631,477,187,14.084507,"303021054",53.169735,473
844,3307,2645,1505,354,82.85455,83.28722,446,"Greenslopes",2740,72.74882,7403,69,3742,1807,3661,80.20012,71.406494,698,6605,76.25628,89.24435,1813,81.529144,1618,64,614,462,607,3298,5385,14.414414,647,444,19.491526,"303021055",63.896847,796
956,2539,2058,1043,348,81.52816,80.04605,299,"Holland Park",2070,70.6067,6177,66,3290,1303,2887,75.32943,61.94503,503,5271,78.791336,87.48921,1159,78.31531,1014,47,675,293,691,2732,4128,8.422939,473,558,18.965517,"303021056",59.44334,877
704,2056,1661,850,360,84.53307,82.92683,270,"Holland Park West",1738,74.005684,4977,61,2561,1025,2416,78.832466,66.666664,422,4163,79.041916,90.99379,966,81.64785,879,38,521,252,528,2107,3399,8.370044,378,454,16.944445,"303021057",63.98104,668
411,2121,1378,733,195,73.88024,75.87992,291,"Woolloongabba",1567,70.07299,4444,32,2128,966,2316,70.666664,58.289703,524,4071,71.92225,80.3351,1134,72.34095,911,23,288,334,333,1950,2945,12.921349,573,178,16.410257,"303021058",55.53435,463
1116,3058,2463,1130,551,80.08502,82.30153,397,"Yeronga",2449,73.02867,7504,109,3895,1373,3609,77.50157,62.98984,697,6236,77.552986,86.01663,1323,78.76844,1138,84,815,434,805,3178,4912,11.715481,689,717,19.782213,"303021059",56.958393,1038
1674,5132,3342,1703,794,75.2728,68.752525,531,"Eight Mile Plains",3863,60.69295,12112,138,6186,2477,5926,63.04471,46.347828,1157,10433,76.21262,82.8745,2470,69.059715,2047,90,1016,533,1147,5301,7205,10.169492,1150,885,17.380352,"303031060",45.894554,1505
1076,2577,1977,812,589,79.27823,74.08759,313,"Mansfield (Qld)",2043,69.237915,6642,82,3476,1096,3166,70.83482,56.865913,584,5368,78.70183,86.59384,1007,74.88823,872,68,745,352,776,2791,4020,9.927008,619,685,13.921902,"303031062",53.59589,986
1616,4755,3672,1860,758,80.79916,79.25011,564,"Mount Gravatt",3842,70.792076,11477,109,5964,2347,5513,74.49787,59.420288,984,9684,76.87943,88.310036,2361,77.5919,2085,94,1144,574,1084,4929,7514,9.082126,966,1035,14.379948,"303031063",57.317074,1410
756,2032,1511,720,276,80.26575,76.51434,229,"Rochedale - Burbank",1631,67.19577,4747,69,2439,941,2308,70.87242,53.563217,473,4164,81.034485,89.68944,805,75.45629,722,50,508,233,611,2132,3142,16.286646,435,307,25.0,"303031064",48.414375,754
777,3012,1932,993,609,73.04117,71.38749,404,"Upper Mount Gravatt",2200,64.47877,7599,58,3978,1391,3621,62.78843,43.564358,851,6089,74.562584,83.49789,1418,67.86008,1184,42,501,396,554,3077,4132,4.661487,909,901,9.523809,"303031065",47.47356,743
1384,3154,2516,1084,744,81.896,75.487465,365,"Wishart",2583,69.29191,8372,120,4474,1436,3898,71.27479,55.35211,693,6684,81.86901,88.75104,1209,76.28665,1073,80,959,393,1025,3530,5099,8.474576,710,944,16.129032,"303031066",52.66955,1252
532,1891,1149,579,256,69.06399,66.62831,197,"Coopers Plains",1306,61.654137,4337,32,2190,869,2147,61.741,47.391304,443,3752,68.61167,77.39222,951,65.43177,736,24,328,218,341,1861,2455,7.2948327,460,329,12.5,"303041067",44.469524,497
683,2436,1645,866,354,75.69787,80.2595,286,"Salisbury - Nathan",1844,73.49927,5544,34,2754,1079,2790,72.88436,51.515152,568,4693,76.44628,84.851135,1142,74.34477,969,22,502,255,555,2257,3489,4.4265594,495,497,9.60452,"303041070",50.35211,726
1116,3541,2644,1353,491,79.63852,79.588234,406,"Moorooka",2820,73.29749,8140,65,4108,1700,4032,76.0207,62.23565,652,7019,74.16021,86.111115,1728,77.84585,1488,61,818,412,861,3478,5464,9.68254,662,630,13.238289,"303041068",62.26994,1161
504,1765,936,445,326,66.85552,61.37931,199,"Robertson",1180,53.57143,4195,56,2104,725,2091,55.31915,39.956802,485,3457,70.46512,73.17647,850,61.20914,622,36,270,185,303,1692,2116,8.7378645,463,412,17.177914,"303041069",41.03093,430
2422,6961,4727,2502,878,76.95734,69.05879,691,"Calamvale - Stretton",5357,60.404625,16244,179,8405,3623,7839,63.1361,48.19695,1515,14448,79.11985,84.50151,3310,69.79513,2797,67,1463,695,1690,7487,10084,7.298475,1442,918,20.387243,"303051073",45.61056,2136
551,1528,1179,590,134,82.918846,79.40781,173,"Pallara - Willawong",1267,68.965515,3418,34,1756,743,1662,72.77778,59.202454,300,3148,82.69962,89.03134,702,77.70013,625,16,380,193,435,1620,2446,11.764706,326,136,25.373135,"303051074",57.666668,526
1837,4959,3762,1878,566,80.68159,76.094,550,"Parkinson - Drewvale",4001,67.99129,11496,90,5971,2468,5525,71.00793,57.804634,1057,10257,83.50148,88.13712,2217,75.6849,1954,61,1249,574,1407,5298,7763,9.063893,993,673,15.90106,"303051075",52.034058,1685
965,3055,1685,822,535,68.77251,63.62229,323,"Rocklea - Acacia Ridge",2101,53.367874,7100,60,3510,1292,3590,58.608696,50.647247,672,5930,67.14876,75.477036,1415,63.844856,1068,35,515,313,650,2875,3786,5.5118113,618,635,11.214953,"303051076",48.065475,968
685,2077,1390,716,236,79.05633,68.64813,206,"Underwood",1642,66.423355,4650,46,2337,1043,2313,66.53902,50.69252,413,4166,76.677315,87.668594,1038,72.77965,910,36,455,183,480,2089,3032,14.516129,361,248,19.491526,"311061335",49.878933,626
899,2596,1596,745,463,77.38829,64.05847,271,"Kuraby",2009,63.84872,6203,76,3144,1163,3059,60.340263,41.509434,596,5241,78.39081,86.72566,1130,68.784584,980,35,574,242,682,2645,3605,7.014028,583,499,16.414686,"303061077",45.4698,870
1532,5185,2974,1590,550,73.6162,63.906754,581,"Runcorn",3817,58.877285,11254,100,5519,2488,5735,60.508648,47.26257,1183,10100,73.19588,81.01362,2644,67.237625,2142,59,902,423,994,4915,6791,9.768212,895,604,18.181818,"303061078",49.112427,1358
880,3176,1692,852,524,65.239296,62.60103,343,"Sunnybank",2072,54.204544,7389,74,3689,1361,3700,55.97089,38.235294,860,6199,66.46267,74.182785,1499,60.71947,1112,64,477,299,543,3023,3764,9.60961,782,666,14.122137,"303061079",39.88372,817
1994,5817,3548,1783,1191,71.92711,66.40596,585,"Sunnybank Hills",4184,55.917755,14214,206,7206,2685,7008,60.432636,44.63087,1367,11688,72.15333,78.961136,2676,66.15332,2113,118,1115,532,1280,5871,7732,8.838951,1192,1335,17.29639,"303061080",42.79444,1774
358,3009,2019,1327,145,83.74876,82.16718,389,"Fortitude Valley",2520,62.290504,5877,28,2723,1615,3154,78.34692,74.66888,493,5586,67.4,87.599205,2016,81.256714,1766,18,223,451,337,2577,4539,12.328767,604,146,19.310345,"305011106",78.90466,500
1179,3785,1547,694,676,60.58124,41.88292,369,"Woodridge",2293,46.81934,8856,74,4395,1657,4461,41.958233,28.67215,885,7472,59.369675,66.80186,1726,51.391865,1153,57,552,244,697,3687,3840,8.050847,851,708,10.946746,"311061336",41.694916,1174
991,2235,1828,745,627,86.800896,80.62771,247,"Jindalee - Mount Ommaney",1940,70.73663,5887,153,3025,924,2862,77.589134,63.038548,451,4591,83.01887,89.69422,883,82.07362,792,104,701,278,748,2356,3768,15.54559,441,669,24.401915,"304011081",54.767185,901
1387,3104,2081,746,1055,80.670105,71.661865,359,"Tully",2504,68.20476,7941,188,3782,1041,4159,72.031845,62.689804,540,5993,71.76625,82.997116,1041,76.50592,864,100,946,289,1093,2889,4585,11.198208,461,893,17.819904,"306031161",66.48148,1523
0,0,0,0,0,0.0,0.0,0,"Wooroonooran",0,0.0,0,0,0,0,0,0.0,0.0,0,0,0.0,0.0,0,0.0,0,0,0,0,0,0,0,0.0,0,0,0.0,"306031162",0.0,0
238,788,182,83,36,20.30457,28.327644,25,"Yarrabah",160,29.411764,1641,0,817,293,824,23.9159,11.304348,232,1549,23.555555,24.773415,331,22.07876,82,3,70,26,53,761,342,5.357143,230,56,0.0,"306031163",10.775862,225
856,1809,1348,507,497,77.33554,75.33433,160,"Daintree",1399,72.54673,4542,110,2236,673,2306,75.73034,55.776894,271,3589,67.86851,82.184875,595,76.53943,489,80,621,140,640,1780,2747,17.54386,251,456,22.132797,"306041164",59.040592,943
716,1547,1349,597,374,90.7563,85.40772,142,"Port Douglas",1404,72.765366,3821,106,1900,699,1921,83.68486,76.64975,182,3159,78.22932,91.27219,676,87.147835,617,80,521,151,539,1612,2753,27.777779,197,288,28.342245,"306041165",78.02198,689
1411,2727,2131,781,1084,82.03154,71.064606,362,"Atherton",2237,65.34373,8082,178,4271,1099,3811,70.02958,61.163227,552,5770,72.78481,85.290886,911,75.701904,777,102,922,326,920,3043,4368,8.306189,533,1228,16.420664,"306051166",65.57971,1264
797,1433,833,239,571,60.711792,55.581394,106,"Herberton",870,57.089085,3975,87,1971,430,2004,56.86007,31.512606,259,2898,54.098362,65.091866,381,58.764664,248,64,455,75,429,1465,1703,12.648221,238,506,15.236427,"306051167",40.92664,793
709,1268,902,306,359,72.55521,66.95843,61,"Kuranda",920,67.4189,3263,81,1636,457,1627,69.01301,41.13475,161,2575,70.02924,70.68558,423,70.75728,299,60,478,58,479,1307,1822,18.237082,141,329,22.562674,"306051168",37.8882,684
1341,2171,1777,530,983,83.233536,71.42857,187,"Malanda - Yungaburra",1807,67.85981,6467,216,3313,742,3154,74.041664,63.091484,323,4571,71.71717,83.63636,660,78.40735,552,137,910,200,852,2400,3584,15.005476,317,913,21.97355,"306051169",57.894737,1188
1282,2857,2123,825,1023,77.738884,70.03396,347,"Mareeba",2221,67.70671,7991,145,4111,1178,3880,69.62939,56.027164,570,5906,72.522896,79.00552,1086,73.55232,858,100,868,330,871,3049,4344,9.416196,589,1062,14.173998,"306051170",60.877193,1201
983,2259,1713,740,453,83.222664,76.60455,236,"Middle Park - Jamboree Heights",1880,70.19328,5543,87,2831,966,2712,72.893616,57.605984,464,4609,83.61582,89.78022,910,77.95617,817,52,690,231,740,2350,3593,10.810811,401,481,19.205297,"304011082",50.86207,885
88,174,111,47,21,86.206894,81.034485,16,"Mackay Harbour",150,61.363636,372,5,177,58,195,69.81132,76.92308,22,333,75.789474,100.0,57,78.37838,57,0,54,10,72,159,261,0.0,13,18,23.809525,"312021347",72.72727,95
717,1395,1118,352,307,86.666664,78.22222,185,"Westlake",1209,72.24547,3469,91,1767,450,1702,75.4386,63.174603,323,2877,85.38103,89.51049,429,80.882866,384,49,518,199,549,1482,2327,17.192982,315,285,29.641693,"304011085",57.275543,643
535,1285,990,393,328,90.03891,76.75781,134,"Balonne",1157,75.14019,3148,120,1535,512,1613,78.821655,63.157894,218,2541,82.37288,87.42139,477,84.49429,417,63,402,132,486,1256,2147,22.580645,209,279,36.585365,"307011171",61.46789,590
494,1258,1074,522,185,84.5787,79.81651,119,"Riverhills",1064,75.30364,3013,44,1570,654,1443,79.08689,68.09524,218,2616,82.089554,89.498436,638,81.72783,571,37,372,143,330,1358,2138,17.45283,210,212,23.783783,"304011083",54.587154,402
1323,2842,2427,1016,480,84.834625,80.31621,282,"Seventeen Mile Rocks - Sinnamon Park",2411,76.64399,7003,101,3681,1265,3322,77.31762,60.61706,525,5981,85.27454,89.955154,1115,80.88948,1003,63,1014,334,1025,3139,4838,11.623616,551,542,21.041666,"304011084",53.714287,1202
507,1186,790,307,400,88.27993,71.2297,111,"Inglewood - Waggamba",1047,67.45562,3067,122,1481,431,1586,70.661896,44.444443,183,2304,77.75974,86.56331,387,79.7309,335,61,342,80,479,1118,1837,16.804407,180,363,30.5,"307011174",60.65574,616
714,1769,1463,664,284,84.73714,81.17359,209,"Sherwood",1499,70.02801,4352,62,2299,818,2053,76.67715,66.223404,351,3677,85.18519,87.70389,797,80.5548,699,50,500,249,529,1908,2962,12.787724,376,391,21.830986,"304031095",59.54416,621
688,4719,2244,706,444,49.67154,50.754852,791,"St Lucia",2344,67.441864,10812,145,5649,1391,5163,43.768284,32.250656,2566,9846,81.43323,58.99935,1539,46.597603,908,91,464,983,500,5127,4588,17.432951,3048,522,32.657658,"304031096",30.826189,614
696,1753,1206,460,485,73.359955,66.76343,238,"Cranbrook",1286,68.82184,4572,76,2334,689,2238,68.36735,57.78364,453,3517,74.53988,75.0,648,70.85584,486,48,479,219,486,1764,2492,8.421053,379,570,15.670103,"318021472",52.53863,652
1974,6899,5293,2849,603,81.76547,75.912605,953,"Deeragun",5641,70.92199,15297,102,7795,3753,7502,73.40175,65.22911,1472,14110,76.80332,88.74286,3500,77.49114,3106,76,1400,968,1480,7211,10934,13.013699,1484,584,16.915422,"318021473",64.741844,1927
1130,2451,2099,888,355,82.57854,76.354256,268,"Mount Sheridan",2024,74.159294,5969,77,3163,1163,2806,75.96815,68.085106,489,5214,81.27572,89.79798,990,79.07557,889,53,838,320,790,2763,4123,13.25,470,400,21.690142,"306021153",54.805725,972
673,1567,1147,407,469,90.299934,74.27007,215,"Pittsworth",1415,69.687965,4094,131,2058,548,2036,75.460526,62.20736,339,3087,85.3835,89.19926,537,82.993195,479,85,469,186,590,1520,2562,15.799256,299,538,27.93177,"307021182",63.42183,691
1284,3041,2531,1041,553,84.61033,79.10334,371,"Bellbowrie - Moggill",2573,76.63551,7508,139,3914,1316,3594,77.28244,60.88889,722,6316,85.10985,93.30275,1090,80.81064,1017,95,984,411,1046,3275,5104,14.86698,675,639,25.135624,"304021086",51.38504,1229
1055,1933,1505,392,545,85.15261,73.962265,254,"Brookfield - Kenmore Hills",1646,71.753555,5091,148,2613,530,2478,73.666176,59.82533,514,3976,86.06383,90.81419,479,79.2505,435,82,757,274,809,2043,3151,14.385965,458,570,27.155964,"304021087",49.416344,940
560,1181,929,355,273,83.48857,80.49886,157,"Wamuran",986,70.0,2936,53,1482,441,1454,75.405846,66.666664,244,2413,78.09524,88.83495,412,79.36179,366,28,392,154,410,1232,1915,11.2,231,250,19.41392,"313021369",64.34426,525
1430,3066,2455,897,808,83.20287,74.31649,341,"Chapel Hill",2551,72.30769,8007,213,4133,1207,3874,74.43906,61.57337,715,6364,82.97872,87.24584,1082,78.66122,944,117,1034,407,1053,3298,5006,14.011976,661,835,26.361385,"304021088",47.692307,1269
1684,3125,2682,1050,816,81.568,76.97947,273,"Clifton Beach - Kewarra Beach",2549,73.396675,8182,150,4241,1364,3941,76.345,63.225807,496,6638,76.23169,87.04525,1127,78.803856,981,102,1236,294,1145,3513,5231,14.010989,465,728,18.382353,"306011139",55.04032,1502
607,1457,1246,496,487,86.7536,80.258896,163,"West Beach",1264,76.27677,4036,83,2092,618,1944,81.75853,73.91304,258,2981,79.36508,91.0369,569,84.199936,518,66,463,221,500,1524,2510,11.619719,299,568,17.043121,"404031109",63.178295,630
597,1537,984,443,330,64.02082,62.83688,145,"Manunda",984,60.301506,3795,54,1928,705,1867,61.23211,42.95082,307,3144,60.78767,66.56347,646,62.59542,430,50,360,131,355,1607,1968,15.576324,305,321,16.363636,"306021152",47.23127,584
697,3013,2252,1096,416,77.59708,74.9658,503,"Taringa",2338,69.29699,7158,102,3729,1462,3429,71.58296,60.385006,926,6159,81.0084,83.84718,1492,74.525085,1251,77,483,596,482,3146,4590,13.207547,987,583,24.51923,"304031097",54.319653,595
1058,2537,1846,780,565,81.94718,74.215034,293,"Gordonvale - Trinity",2079,69.65974,6170,121,3068,1051,3102,71.80086,56.060608,514,5108,79.67183,85.421165,926,76.84025,791,70,737,259,874,2571,3925,14.084507,462,497,21.41593,"306021148",57.00389,1097
469,988,609,205,255,79.8583,65.07937,85,"Mallala",789,62.473347,2419,81,1176,315,1243,63.83648,45.294117,170,1942,71.91919,82.66254,323,71.98764,267,34,293,77,356,954,1398,15.315315,170,222,31.764706,"405011113",50.0,495
592,1215,911,301,235,83.12757,73.05825,152,"Fig Tree Pocket",1010,69.932434,2958,68,1508,412,1450,72.12985,58.30116,305,2478,85.68873,88.60399,351,77.522194,311,45,414,151,479,1263,1921,18.367348,259,245,28.93617,"304021089",49.836067,559
1139,2338,1641,580,663,81.82207,71.42857,220,"Johnstone",1913,67.86655,5892,172,2891,812,3001,71.94213,62.121212,379,4619,71.83673,87.3297,734,76.94306,641,83,773,205,880,2281,3554,13.606558,330,610,25.942684,"306031160",58.047493,1225
1128,2498,2134,842,688,86.028824,78.39851,292,"Kenmore",2149,75.53191,6765,162,3579,1074,3186,77.65648,57.142857,551,5246,85.496956,88.657646,961,81.64316,852,128,852,312,843,2748,4283,15.403129,546,831,23.54651,"304021090",52.994556,986
817,1551,1287,410,400,87.23404,80.078125,177,"Pinjarra Hills - Pullenvale",1353,73.31702,4019,116,2068,512,1951,75.839714,58.423912,356,3248,87.4837,90.88785,428,81.280785,389,63,599,215,671,1697,2640,16.981133,368,371,29.0,"304021091",49.7191,767
935,2237,1797,735,411,85.69513,79.545456,266,"Chelmer - Graceville",1917,74.33155,5506,96,2858,924,2648,76.30573,58.669353,501,4592,86.08018,93.31742,838,80.87979,782,76,695,291,773,2355,3714,15.109344,496,503,23.357664,"304031092",53.09381,898
596,1475,1169,484,287,80.81356,78.69919,170,"Corinda",1192,74.66443,3622,55,1860,615,1762,77.46852,65.77181,321,2984,80.21201,87.244896,588,79.12199,513,44,445,196,454,1509,2361,12.535612,298,351,19.163763,"304031093",52.959503,566
1200,4221,2811,1194,563,73.48969,68.4633,633,"Indooroopilly",3102,67.833336,9810,143,5026,1744,4784,64.784515,51.039425,1347,8560,80.27149,81.34539,1769,69.0771,1439,91,814,712,887,4339,5913,13.245997,1395,687,25.399645,"304031094",46.993317,1105
0,0,0,0,0,0.0,0.0,0,"Mount Coot-tha",0,0.0,0,0,0,0,0,0.0,0.0,0,0,0.0,0.0,0,0.0,0,0,0,0,0,0,0,0.0,0,0,0.0,"304041102",0.0,0
777,4218,2416,1304,313,70.45993,68.81267,464,"Brisbane City",2972,65.25097,8727,119,4196,1895,4531,61.616936,43.31465,1144,8139,79.2584,77.114426,2211,66.199776,1705,64,507,541,684,3921,5388,23.272728,1249,275,38.01917,"305011105",40.55944,863
727,3044,2066,1070,286,85.840996,81.86687,782,"Enoggera",2613,72.489685,6393,46,3063,1307,3330,78.88507,76.068375,963,5663,79.0393,89.09612,1394,82.624054,1242,24,527,445,543,2619,4679,5.4054055,585,444,16.083916,"304041098",81.20457,687
0,6,0,0,0,100.0,0.0,0,"Enoggera Reservoir",6,0.0,13,0,7,3,6,0.0,0.0,0,9,100.0,100.0,3,66.666664,3,0,0,0,3,3,6,0.0,0,4,0.0,"304041099",0.0,3
794,1933,1514,733,536,76.927055,74.643585,186,"Keperra",1487,65.74307,5470,64,3001,982,2469,71.48253,59.064327,372,4051,71.583855,84.62377,917,74.080475,776,57,522,202,461,2118,3001,6.455266,342,883,11.940298,"304041100",50.0,644
921,2552,2145,1100,378,81.07367,80.527084,250,"Mitchelton",2069,75.352875,6258,55,3328,1366,2930,77.269455,61.55419,463,5328,78.438225,88.62713,1231,79.09159,1091,50,694,301,673,2776,4214,9.057971,489,552,14.550264,"304041101",53.99568,858
2259,4796,4037,1536,1160,85.09174,81.141045,570,"The Gap",4081,75.91855,12481,233,6525,1893,5956,78.47978,61.89516,1064,9940,85.96071,90.21277,1645,81.67002,1484,172,1715,614,1794,5144,8118,12.454743,992,1381,20.086206,"304041103",53.57143,2087
1230,3019,2414,1091,507,83.70322,77.651245,332,"Upper Kedron - Ferny Grove",2527,71.46342,7248,71,3722,1405,3526,75.03886,65.12028,610,6236,83.64445,92.13396,1284,79.23348,1183,65,879,379,941,3217,4941,12.871287,582,505,14.003944,"304041104",54.42623,1125
1199,2323,2084,816,578,84.761086,80.0,232,"Whitfield - Edge Hill",1969,77.56464,6155,120,3254,1020,2901,80.21555,63.32454,369,4921,80.592995,85.612366,841,82.361305,720,98,930,240,897,2598,4053,14.939024,379,656,20.761246,"306021156",62.872627,1113
681,2265,1644,787,278,76.33554,77.7668,338,"Highgate Hill",1729,76.3583,5062,71,2519,1012,2543,74.59165,59.49119,569,4469,76.26194,79.02388,963,75.475494,761,33,520,304,559,2204,3373,10.476191,511,315,25.539568,"305011107",59.402462,733
515,2736,1813,1054,254,72.807014,73.29624,308,"South Brisbane",1992,68.73786,6020,67,3030,1438,2990,64.93553,42.550655,694,5528,77.54386,79.82337,1472,68.831406,1175,48,354,357,442,2792,3805,20.168068,839,238,26.377953,"305011110",44.3804,570
805,2210,1540,674,511,86.87783,67.670685,298,"Chinchilla",1920,66.95652,5439,148,2718,996,2721,69.120285,59.01639,447,4438,78.95363,87.85249,922,77.96304,810,75,539,252,664,2228,3460,15.306123,427,490,28.962818,"307011172",66.666664,841
692,1724,1452,621,391,90.08121,79.51344,243,"Goondiwindi",1553,78.46821,4398,104,2283,781,2115,80.398674,69.06907,341,3530,83.42857,91.06882,683,85.12748,622,58,543,230,584,1806,3005,12.159329,333,477,26.598465,"307011173",71.260994,700
788,3113,2291,1249,498,84.48442,80.9987,309,"Kangaroo Point",2630,67.766495,7103,164,3492,1542,3611,78.13779,67.441864,517,6045,76.20192,86.33787,1764,81.40612,1523,102,534,406,634,2932,4921,18.214285,602,560,32.93173,"305011108",59.76789,832
353,2619,1494,908,161,73.501335,72.46608,309,"Spring Hill",1925,67.70538,5054,51,2274,1253,2780,69.845726,59.287056,602,4758,66.36198,81.76871,1470,71.857925,1202,31,239,316,363,2139,3419,22.962963,533,135,31.67702,"305011111",51.328903,547
418,1202,834,335,274,95.008316,74.27938,120,"Miles - Wandoan",1142,76.79426,2819,106,1343,451,1476,78.4572,54.12371,175,2265,84.538155,93.57278,529,87.240616,495,73,321,105,421,1063,1976,26.071428,194,280,38.68613,"307011175",68.57143,498
1251,4203,3500,2021,676,86.34309,86.81271,400,"New Farm",3629,71.3829,9884,165,5005,2328,4879,83.05648,74.96063,566,8417,73.64048,90.315605,2313,84.69764,2089,110,893,476,975,4214,7129,13.906447,635,791,24.408283,"305011109",70.67138,1324
279,932,842,458,94,87.66094,84.81481,118,"Albion",817,77.06093,2259,28,1233,540,1026,78.83895,60.240963,172,2000,78.13765,93.17739,513,82.95,478,19,215,150,193,1068,1659,11.515152,249,165,29.787233,"305031119",68.60465,247
1000,3364,2591,1370,372,79.31035,80.351906,387,"West End",2668,72.4,7555,77,3819,1705,3736,76.2283,62.536022,672,6763,78.60082,83.72093,1720,77.761345,1440,63,724,434,764,3399,5259,15.0,694,420,20.698925,"305011112",57.589287,972
532,1345,1154,551,158,87.65799,81.99405,141,"Balmoral",1179,77.06767,3127,31,1624,672,1503,80.362114,74.13793,218,2781,83.92157,93.84116,617,83.890686,579,21,410,172,428,1436,2333,11.170213,232,188,19.620253,"305021113",64.6789,510
689,1996,1631,773,323,87.77555,80.10363,312,"Roma",1752,78.51959,4743,66,2424,965,2319,79.48343,67.08543,416,4048,80.938416,91.53675,898,83.572136,822,50,541,267,552,2052,3383,13.44086,398,372,20.433437,"307011176",75.0,682
701,1698,1321,491,492,97.70318,78.6859,184,"Roma Region",1659,76.89016,4187,219,1997,624,2190,84.84264,62.5,269,3255,84.91272,91.706535,627,91.55146,575,146,539,145,681,1557,2980,33.18182,232,440,44.512196,"307011177",68.40149,802
491,1090,605,199,354,69.90826,56.857143,88,"Tara",762,56.415478,2701,99,1257,350,1444,60.987904,49.006622,187,2082,59.05097,71.556885,334,65.65802,239,55,277,74,336,992,1367,20.754717,151,265,27.966103,"307011178",47.058823,569
1128,2206,1535,507,989,82.5476,64.25855,189,"Crows Nest - Rosalie",1821,62.765957,6422,217,3227,789,3195,68.010635,52.35294,340,4463,71.772804,82.52841,704,75.19606,581,142,708,178,834,2257,3356,14.639175,340,970,21.941355,"307021179",55.588234,1162
946,2282,1514,555,577,86.24014,70.70064,343,"Jondaryan",1968,67.86469,5546,162,2687,785,2859,70.517,56.971153,508,4429,78.194725,87.81726,788,78.618195,692,80,642,237,771,2147,3482,14.814815,416,540,28.076256,"307021180",67.519684,986
403,931,600,205,276,86.14393,66.129036,108,"Millmerran",802,66.00496,2321,79,1114,310,1207,70.42254,55.395683,156,1783,75.21186,85.80858,303,78.63152,260,52,266,77,355,852,1402,19.847328,139,262,28.623188,"307021181",69.23077,472
829,2118,1773,895,298,87.913124,81.73516,201,"Bulimba",1862,74.42702,4976,66,2560,1095,2416,78.52081,67.66467,326,4376,84.78261,92.63486,964,83.06673,893,35,617,226,702,2258,3635,11.589404,334,302,22.147652,"305021114",61.65644,828
1912,4900,3429,1390,1147,85.408165,70.55837,665,"Wambo",4185,66.99791,12145,341,6098,1970,6047,70.23761,59.1,1064,9782,79.29953,86.42746,1923,77.836845,1662,167,1281,591,1517,4882,7614,13.733553,1000,1216,29.72973,"307021183",62.5,1913
656,1328,998,349,514,88.10241,70.79108,154,"Clifton - Greenmount",1170,66.61585,3676,165,1834,493,1842,72.371284,46.95652,266,2707,75.0,87.674416,430,80.08866,377,104,437,108,474,1379,2168,22.857143,230,455,32.101166,"307031184",57.894737,632
633,1171,876,279,427,85.738686,74.202126,123,"Southern Downs - East",1004,67.29858,3192,123,1594,376,1598,74.300255,61.17647,211,2350,75.645164,85.0,340,80.0,289,67,426,104,469,1179,1880,16.144579,170,415,28.80562,"307031185",58.29384,620
709,1283,866,250,558,83.32034,64.76684,149,"Southern Downs - West",1069,62.48237,3594,161,1753,386,1841,67.65625,57.2973,252,2563,68.9911,82.35294,357,75.49747,294,67,443,106,465,1280,1935,14.164905,185,473,28.853046,"307031186",59.126984,674
528,2239,1567,864,219,79.09781,83.31726,349,"East Brisbane",1771,71.969696,4681,52,2223,1037,2458,78.546364,67.906975,567,4234,75.31306,85.26505,1113,78.837975,949,31,380,292,421,1995,3338,13.596491,430,228,23.744291,"305021115",61.55203,559
697,1655,1315,556,324,90.87613,78.97727,173,"Ascot",1504,72.59684,4079,117,2100,704,1979,76.32037,59.31677,286,3378,85.38012,91.9708,685,83.451744,630,62,506,191,584,1723,2819,16.445623,322,377,36.11111,"305031121",60.48951,684
622,1646,1390,665,146,86.87728,81.795815,191,"Hawthorne",1430,75.72347,3736,49,1944,813,1792,78.354004,67.55162,305,3420,84.16523,92.23684,760,82.45614,701,25,471,229,489,1774,2820,14.705882,339,170,33.561646,"305021116",62.62295,581
1307,4046,2988,1423,316,89.6441,73.0868,562,"Emerald",3627,74.751335,8685,126,4323,1947,4362,74.21758,68.78239,806,8072,86.89249,93.4644,1882,81.94995,1759,57,977,531,1180,4026,6615,19.19192,772,297,39.873417,"308011192",69.72705,1358
1183,4264,3761,2181,393,85.8818,85.02924,493,"Morningside - Seven Hills",3662,74.80981,9804,62,5147,2565,4657,82.01047,74.10501,719,8850,79.55157,91.358025,2430,83.87571,2220,74,885,621,887,4586,7423,13.190731,838,561,15.776081,"305021117",68.56745,1115
652,2641,2082,1131,247,82.393036,84.08922,349,"Windsor",2176,72.69939,5739,54,2851,1345,2888,80.79162,73.44827,525,5218,77.746475,86.8421,1406,81.60215,1221,51,474,426,552,2577,4258,18.613138,580,274,21.862349,"305031130",66.47619,710
739,2047,1820,899,214,88.32438,84.8914,243,"Norman Park",1808,83.220566,4689,62,2428,1059,2261,83.52455,66.666664,368,4226,84.88372,92.73461,991,85.8495,919,52,615,254,584,2179,3628,20.883533,381,249,28.971962,"305021118",66.03261,688
674,2014,1761,864,255,86.14697,85.03937,299,"Alderley",1735,76.11276,4692,52,2423,1016,2269,82.44382,76.90583,445,4150,83.70968,91.148575,949,84.24097,865,41,513,343,519,2136,3496,14.285714,446,287,20.392157,"305031120",67.19101,620
967,2527,1732,733,387,74.515236,63.850174,362,"Morayfield - East",1883,62.564632,6084,39,3170,1148,2914,63.073563,58.00317,609,5273,72.03792,81.37803,1074,68.5568,874,28,605,366,608,2746,3615,6.6037736,631,424,10.077519,"313021368",59.441708,844
1213,3367,2904,1406,533,86.48649,80.06834,370,"Clayfield",2912,73.12448,8308,121,4408,1756,3900,78.00161,66.97613,572,7090,81.10517,90.316795,1673,82.03103,1511,106,887,505,910,3723,5816,15.474453,754,685,22.701689,"305031122",64.68532,1122
521,1322,1134,525,149,87.065056,83.598724,157,"Grange",1151,82.917465,3076,29,1605,628,1471,81.64147,66.25,242,2711,83.425415,95.344505,537,84.28624,512,18,432,159,453,1389,2285,8.333333,240,216,19.463087,"305031123",64.87603,543
716,1526,997,348,493,78.57143,64.56401,119,"Kilcoy",1199,63.826817,3991,114,1972,539,2019,66.95769,55.982906,247,3015,68.27486,83.86555,595,72.83582,499,61,457,131,467,1489,2196,12.629399,234,483,23.123732,"313031370",48.17814,684
936,2871,1360,523,604,54.824104,72.23757,216,"Woodford - D'Aguilar",1574,62.713676,6005,104,2530,724,3475,68.582954,57.58514,566,4854,66.83119,44.659443,1292,60.444992,577,64,587,186,677,1983,2934,11.700183,323,547,17.218542,"313031371",38.162544,1013
718,2092,1694,811,373,91.491394,81.1,237,"Hamilton (Qld)",1914,72.841225,4959,133,2494,1000,2465,79.86799,69.97519,355,4213,85.69463,91.18812,1010,85.63969,921,78,523,282,623,2121,3608,20.911528,403,373,35.656837,"305031124",66.76057,727
645,1420,1219,472,267,89.08451,80.0,153,"Hendra",1265,79.379845,3506,78,1819,590,1687,80.781975,70.43796,237,2929,85.25641,89.80322,559,84.8071,502,42,512,193,532,1509,2484,13.548388,274,310,29.213484,"305031125",64.55696,624
2070,5706,4429,2055,644,83.14056,75.35754,748,"Narangba",4744,71.78744,13065,105,6715,2727,6350,72.89335,63.408913,1284,11782,84.395065,91.03046,2397,77.85605,2182,77,1486,811,1709,6076,9173,12.050078,1279,639,16.304348,"313041375",58.25545,2025
457,947,713,243,205,84.05491,78.64078,129,"Upper Caboolture",796,67.177246,2281,49,1129,309,1152,74.116425,69.38776,197,1909,77.41228,90.136055,294,79.04662,265,27,307,136,353,962,1509,16.167665,196,167,23.90244,"313041376",65.48223,456
587,3676,2241,1085,235,62.758434,65.20433,532,"Kelvin Grove - Herston",2307,70.86883,8000,54,4089,1664,3911,58.91167,45.717964,1290,7480,74.8366,71.19504,1774,60.80214,1263,30,416,710,458,3804,4548,10.526316,1553,285,22.978724,"305031126",41.24031,612
502,1775,1379,635,183,82.30986,80.176765,300,"Newmarket",1461,75.49801,3958,34,2000,792,1958,77.82167,70.711296,449,3547,80.482895,87.69602,829,80.067665,727,27,379,338,400,1772,2840,11.842105,478,228,18.579235,"305031127",66.81515,497
918,4004,3304,2046,364,89.31069,87.28669,390,"Newstead - Bowen Hills",3576,73.42048,8671,132,4303,2344,4368,84.00712,76.45306,529,7937,78.77211,91.36834,2514,86.682625,2297,71,674,513,757,3933,6880,19.18919,671,370,36.263737,"305031128",73.72401,961
487,1296,1075,483,155,83.71914,83.419685,150,"Wilston",1085,75.77002,2961,39,1510,579,1451,79.80698,68.3274,255,2643,80.4,91.312386,541,81.72531,494,31,369,192,402,1347,2160,19.018404,281,163,25.161291,"305031129",58.82353,500
1021,3425,2666,1353,349,82.59854,80.87268,432,"Wooloowin - Lutwyche",2829,72.869736,7649,70,3875,1673,3774,78.1589,70.711296,670,6836,77.76717,88.57645,1707,80.38326,1512,62,744,507,815,3411,5495,13.362069,717,464,20.057306,"305031131",64.477615,1048
1709,4291,3471,1406,568,83.78001,82.36672,626,"Ashgrove",3595,77.99883,9885,132,5026,1707,4859,79.86655,68.70968,1027,8637,84.37307,89.42249,1645,81.810814,1471,93,1333,639,1366,4346,7066,13.676471,930,680,23.239437,"305041132",60.954235,1619
496,1980,1558,756,230,82.121216,81.11588,298,"Auchenflower",1626,75.80645,4436,69,2226,932,2210,79.28753,69.087524,521,3945,84.024895,87.41044,977,80.70976,854,55,376,371,405,1965,3184,21.072798,537,261,30.0,"305041133",57.197697,482
964,2232,1587,616,514,71.14695,64.978905,278,"Kirwan - East",1588,65.45643,5863,69,3117,948,2746,64.98772,53.773586,505,4674,67.12963,76.59328,863,67.92897,661,55,631,285,580,2442,3175,8.148149,530,675,13.424125,"318021481",55.049503,864
1255,2896,2528,1062,446,87.258286,81.19266,353,"Bardon",2527,76.81275,7191,120,3849,1308,3342,77.56981,59.482758,564,6155,84.46115,91.89427,1135,82.12835,1043,88,964,414,1011,3259,5055,14.915255,696,590,26.90583,"305041134",62.588654,1197
1088,3817,3223,1682,383,86.45533,85.0784,528,"Paddington - Milton",3300,74.08088,8651,124,4451,1977,4200,80.655655,71.75081,818,7813,82.93613,91.17949,1950,83.48906,1778,67,806,668,870,3996,6523,14.725275,931,455,32.37598,"305041135",64.547676,1049
557,2050,1638,855,186,80.39024,82.05374,256,"Red Hill (Qld)",1648,77.55835,4477,36,2241,1042,2236,80.4914,71.55963,398,4085,78.40909,84.26641,1036,80.440636,873,39,432,312,483,2035,3286,18.93204,436,206,19.35484,"305041136",64.32161,616
772,1698,1417,601,236,85.924614,80.24032,187,"Brinsmead",1459,78.367874,3933,67,1999,749,1934,79.02956,65.07353,317,3491,84.573006,90.229004,655,82.38327,591,34,605,177,614,1793,2876,16.504854,272,206,28.38983,"306011138",58.990536,726
874,3874,2900,1444,440,74.54827,77.63441,579,"Toowong",2888,73.11213,8917,109,4603,1860,4314,70.38835,52.66955,1188,7994,79.334915,83.08026,1844,72.404305,1532,87,639,730,668,4120,5788,18.012423,1386,483,24.772728,"305041137",48.737373,842
788,2306,1809,909,226,79.14137,73.722626,284,"Bentley Park",1825,70.81218,5337,47,2805,1233,2532,71.10849,58.69981,517,4850,78.759895,87.00291,1031,74.92783,897,35,558,307,597,2544,3634,13.409962,523,261,20.796461,"306021144",54.9323,758
555,1065,970,381,213,88.826294,78.88199,102,"Freshwater - Stratford",946,78.73874,2674,59,1396,483,1278,80.833336,67.90124,167,2265,85.71429,89.526184,401,84.59161,359,42,437,110,426,1200,1916,21.428572,162,196,27.69953,"306011140",61.077843,497
1681,3781,3282,1403,485,84.87173,79.988594,443,"Redlynch",3209,77.69185,8907,104,4641,1754,4266,78.742805,66.302864,762,7949,85.46398,91.00135,1478,81.65807,1345,87,1306,486,1317,4168,6491,18.393234,733,473,21.443298,"306011141",58.136482,1541
1744,4302,3533,1621,703,80.89261,78.65114,430,"Trinity Beach - Smithfield",3480,75.45872,10326,141,5321,2061,5005,75.94583,59.50413,826,8954,79.63526,87.32933,1831,78.32254,1599,92,1316,504,1310,4652,7013,13.751868,847,669,20.056898,"306011142",52.058113,1645
921,1754,1456,573,423,78.563286,77.01613,166,"Yorkeys Knob - Machans Beach",1378,70.57546,4476,96,2299,744,2177,75.79385,65.234375,276,3675,69.843185,82.74268,649,77.11565,537,66,650,167,579,1921,2834,17.460318,256,378,22.695036,"306011143",60.144928,829
1092,3756,2550,1329,579,74.946754,74.957695,373,"Cairns City",2815,64.83517,8331,146,3996,1773,4335,71.97291,62.38938,652,7299,64.370544,80.55405,1841,73.50322,1483,90,708,423,813,3543,5365,19.86755,678,453,25.215889,"306021145",57.208588,1263
981,2335,2026,926,370,86.20985,79.41681,308,"Reedy Creek - Andrews",2013,72.782875,5761,76,3056,1166,2705,76.39517,65.9406,499,4987,85.210464,91.954025,957,80.99058,880,53,714,333,749,2652,4039,13.118812,505,404,20.54054,"309051245",61.723446,879
1038,2287,1866,762,654,82.50984,77.1255,236,"Earlville - Bayview Heights",1887,71.1946,6180,141,3239,988,2941,76.79012,64.10891,417,4717,77.032524,84.87585,886,79.56328,752,106,739,259,758,2430,3753,13.102595,404,809,21.559633,"306021146",56.594723,984
1310,2800,2301,995,559,80.78571,75.49317,316,"Kanimbla - Mooroobool",2262,71.37405,7136,114,3777,1318,3359,72.79342,53.658535,547,5961,78.47222,84.28701,1101,76.54756,928,85,935,286,904,3161,4563,13.798701,533,616,20.39356,"306021149",57.769653,1152
0,0,0,0,0,0.0,0.0,0,"Lamb Range",0,0.0,0,0,0,0,0,0.0,0.0,0,0,0.0,0.0,0,0.0,0,0,0,0,0,0,0,0.0,0,0,0.0,"306021150",0.0,0
1127,3042,2267,1081,497,79.026955,71.5894,377,"Edmonton",2404,66.193436,7307,85,3768,1510,3539,68.283134,56.36896,653,6362,76.92308,84.8855,1310,73.42031,1112,55,746,385,830,3320,4671,12.276786,683,448,17.102615,"306021147",57.733536,1079
603,1953,1170,597,417,69.38044,67.995445,200,"Westcourt - Bungalow",1355,59.535656,4677,48,2307,878,2370,64.32105,53.254436,371,3772,61.47427,77.05678,863,66.94061,665,34,359,180,442,1819,2525,6.967213,338,488,11.510792,"306021154",53.908356,719
482,1294,942,439,257,76.661514,69.025154,156,"White Rock",992,65.975105,3280,36,1729,636,1551,67.67242,55.10949,261,2686,72.8,81.801125,533,72.002975,436,34,318,151,364,1392,1934,10.089021,274,337,14.007782,"306021155",59.770115,500
564,1368,972,401,319,70.02924,66.72213,142,"Woree",958,64.53901,3428,57,1741,601,1687,66.57534,59.66102,267,2828,65.45106,72.06896,580,68.24611,418,31,364,176,341,1460,1930,11.032028,295,281,17.868338,"306021157",53.18352,521
610,1230,868,294,426,82.84553,72.77228,115,"Babinda",1019,70.0,3178,124,1522,404,1656,73.68421,56.09756,194,2408,70.67669,83.55795,371,78.363785,310,55,427,92,470,1178,1887,15.988372,164,344,29.10798,"306031158",59.27835,665
546,1492,1024,437,366,74.597855,70.48387,180,"Park Avenue",1113,65.567764,3849,39,1991,620,1858,68.86349,62.92835,322,2979,70.09346,81.732285,635,71.73548,519,27,358,202,375,1487,2137,5.357143,321,504,10.655738,"308031214",55.90062,535
766,1998,1439,657,323,77.17718,73.65471,259,"Parkhurst - Kawana",1542,64.09922,4766,39,2445,892,2321,69.78661,64.10891,442,4060,75.98908,83.47509,823,73.423645,687,32,491,259,557,2062,2981,8.355091,404,383,12.074304,"308031215",58.597286,733
1130,2492,1685,601,798,74.19743,63.130253,301,"Innisfail",1849,64.33628,6737,118,3447,952,3290,65.89754,54.94737,501,5049,65.27273,79.91021,891,69.99406,712,96,727,261,718,2557,3534,10.786517,475,890,14.786967,"306031159",60.07984,1100
690,1312,984,381,638,73.70427,69.78022,130,"Stanthorpe",967,57.971016,4187,73,2237,546,1950,67.12142,65.652176,246,2778,69.3575,74.72767,459,70.230385,343,52,400,151,421,1466,1951,6.744488,230,771,11.442006,"307031187",52.845528,607
856,1599,1071,351,640,78.549095,66.47727,144,"Stanthorpe Region",1256,60.397198,4407,146,2168,528,2239,65.38461,49.212597,263,3237,67.36196,80.03839,521,71.88755,417,78,517,125,549,1638,2327,14.716981,254,530,22.8125,"307031188",54.752853,815
607,1791,1230,577,257,89.78224,75.72179,269,"Biloela",1608,68.039536,4045,50,1997,762,2048,72.8673,67.7116,347,3479,85.71429,91.90821,828,81.575165,761,24,413,216,528,1688,2838,7.76699,319,309,19.455254,"308041529",77.521614,616
967,1827,990,330,634,64.14888,64.453125,92,"Agnes Water - Miriam Vale",1172,52.63702,4580,101,2119,512,2461,59.24596,51.5625,213,3498,55.44643,72.469635,494,61.806747,358,52,509,99,621,1671,2162,11.607142,192,448,15.930599,"308051530",43.19249,1120
1257,3131,1976,894,417,79.303734,67.319275,311,"Boyne Island - Tannum Sands",2483,61.495625,7051,57,3503,1328,3548,64.42778,56.224068,596,6198,79.481316,87.6634,1224,71.942566,1073,38,773,271,1042,3067,4459,8.715596,482,436,13.669065,"308051531",52.18121,1311
0,3,0,0,8,0.0,0.0,0,"Callemondah",0,0.0,15,0,4,0,11,0.0,0.0,0,3,0.0,0.0,0,0.0,0,0,0,0,0,0,0,0.0,0,4,0.0,"308051532",0.0,3
1907,4029,2900,1046,1320,77.66195,66.28644,599,"Warwick",3129,64.44678,11357,180,6008,1578,5349,66.590126,58.390804,966,8384,71.05109,83.82353,1360,71.91078,1140,117,1229,508,1210,4355,6029,7.07804,870,1653,13.636364,"307031189",62.00828,1703
643,2407,1325,634,176,85.375984,63.14741,259,"Central Highlands - East",2055,66.56299,4784,76,2201,1004,2583,64.258,53.012047,430,4469,85.06571,88.42105,1140,75.63213,1008,43,428,220,712,2062,3380,30.935251,415,139,43.18182,"308011190",60.23256,837
899,2398,1557,670,535,87.82319,72.66811,222,"Central Highlands - West",2106,68.40935,5445,150,2512,922,2933,73.6867,61.30137,345,4511,77.367,92.79661,944,81.20151,876,93,615,179,858,2113,3663,23.308271,292,399,28.037384,"308011191",64.347824,1109
688,2065,1287,548,447,71.52542,65.786316,291,"Berserker",1477,62.354652,5032,44,2520,833,2512,64.029854,57.259712,480,4075,65.49296,77.37143,875,67.828224,677,30,429,280,465,2010,2764,5.882353,489,510,9.8434,"308031205",60.625,710
277,555,375,144,152,76.936935,72.0,36,"Bouldercombe",427,63.537907,1365,38,658,200,707,69.57328,51.612904,72,1094,67.666664,81.96722,183,73.30896,150,23,176,32,203,539,802,19.32773,62,119,25.0,"308031206",50.0,300
706,1382,944,342,507,72.50362,63.80597,125,"Emu Park",1002,61.331444,3905,68,2016,536,1889,63.654755,55.18672,246,2865,65.74924,78.63071,482,67.92321,379,36,433,133,430,1483,1946,6.7542214,241,533,13.412229,"308031207",50.813007,654
1161,2694,2142,838,594,80.95769,76.52968,377,"Frenchville - Mount Archer",2181,71.40396,6832,77,3544,1095,3288,75.0,68.333336,600,5550,77.413124,87.429115,1058,77.89189,925,65,829,410,802,2856,4323,9.447675,600,688,12.962963,"308031208",62.833332,1036
623,1939,1076,407,241,62.19701,84.439835,175,"Glenlee - Rockyview",1206,72.87319,3768,45,1588,482,2180,78.71251,70.99236,398,3306,74.9315,54.130703,811,69.02602,439,29,454,186,547,1367,2282,13.122172,262,221,18.6722,"308031209",43.96985,730
1221,3225,2464,1142,458,79.22481,68.34231,406,"Gracemere",2555,65.35626,7905,62,4222,1671,3683,66.30786,59.10194,655,6941,76.27907,84.74916,1495,72.30946,1267,37,798,487,820,3716,5019,7.312253,824,506,13.537118,"308031210",61.984734,1075
529,1493,952,426,290,75.41862,69.04376,189,"Lakes Creek",1126,62.759926,3506,30,1723,617,1783,66.20306,59.931507,326,2931,70.66929,83.156296,659,70.89731,548,19,332,175,359,1438,2078,6.6666665,292,285,10.344828,"308031211",57.97546,508
408,807,360,115,339,49.93804,44.921875,46,"Mount Morgan",403,43.872547,2240,23,1094,256,1146,45.74333,39.8374,136,1594,48.53273,52.19298,228,47.867,119,17,179,49,215,787,763,5.5374594,123,307,6.784661,"308031212",33.82353,443
637,1548,1287,586,257,86.434105,78.97574,206,"Nairne",1338,74.09733,3754,46,1949,742,1805,75.39543,61.280487,329,3255,84.53427,93.07692,650,80.645164,605,28,472,201,481,1707,2625,11.570248,328,242,17.898832,"401021009",62.613983,569
811,1696,1334,442,451,83.54953,79.927666,169,"Uraidla - Summertown",1417,76.44883,4232,131,2085,553,2147,80.50694,63.822525,387,3353,83.65617,88.19876,483,82.04593,426,85,620,187,691,1657,2751,19.859814,293,428,29.046564,"401021010",43.66925,826
1206,3013,2342,1052,522,80.119484,77.75314,397,"Norman Gardens",2414,69.15423,7404,65,3869,1353,3535,72.687775,60.633484,666,6235,78.6309,87.045815,1266,76.27907,1102,54,834,402,850,3222,4756,8.346213,663,647,12.452107,"308031213",59.60961,1081
716,1679,1299,519,411,79.27338,70.80491,247,"Rockhampton - West",1331,69.13408,4413,69,2323,733,2090,71.92691,64.98599,375,3485,72.36641,83.35902,649,75.466286,541,53,495,232,474,1806,2630,10.251451,357,517,16.78832,"308031216",65.86667,655
376,1059,549,214,230,61.473087,62.5731,100,"Rockhampton City",651,56.11702,2443,30,1154,342,1289,61.75478,55.555557,201,1948,57.42358,64.5,400,61.601643,258,29,211,95,263,889,1200,10.943397,171,265,13.043478,"308031217",49.751244,458
484,1049,659,223,310,77.31172,71.935486,100,"Rockhampton Region - East",811,65.28925,2536,54,1177,310,1359,69.957535,60.81081,176,1991,70.60932,83.492065,315,73.832245,263,30,316,90,394,942,1470,12.765958,148,235,17.419355,"308031218",56.81818,558
659,1283,907,303,350,77.86438,74.26471,123,"Rockhampton Region - North",999,67.98179,3178,81,1545,408,1633,71.64297,50.75377,222,2549,71.44971,81.03896,385,74.77442,312,55,448,101,483,1266,1906,19.713263,199,279,23.142857,"308031219",55.405407,676
405,887,655,223,236,89.62796,72.402596,106,"Rockhampton Region - West",795,73.82716,2155,87,1032,308,1123,76.07433,58.783783,183,1748,82.76699,89.38356,292,82.95194,261,46,299,87,341,861,1450,26.900585,148,171,36.864407,"308031220",57.923496,412
0,0,0,0,9,0.0,0.0,0,"Shoalwater Bay",0,0.0,14,0,5,0,9,0.0,0.0,0,0,0.0,0.0,0,0.0,0,0,0,0,0,0,0,0.0,0,5,0.0,"308031221",0.0,0
915,2276,1691,664,538,75.0,78.95363,299,"The Range - Allenstown",1707,70.273224,6052,93,3238,841,2814,69.73196,49.0284,603,4701,74.77376,82.88973,789,72.28249,654,56,643,328,661,2425,3398,6.8880687,669,813,17.286245,"308031222",49.585407,884
2402,5072,3888,1517,1391,77.563095,75.812096,579,"Yeppoon",3934,67.40217,13451,169,6988,2001,6463,72.200554,64.25662,1049,10457,73.47122,86.27015,1799,74.80157,1552,121,1619,631,1634,5385,7822,7.548347,982,1603,12.149532,"308031223",55.195423,2224
1034,2553,1885,724,648,96.239716,75.181725,280,"Banana",2457,75.4352,6133,285,2932,963,3201,80.1105,62.07865,414,4906,86.31309,91.03093,970,88.503876,883,160,780,221,1009,2353,4342,27.633852,356,579,43.98148,"308041528",67.63285,1169
1296,4310,2706,1344,408,80.510445,63.787376,580,"Clinton - New Auckland",3470,62.34568,9459,66,4741,2107,4718,63.88102,61.94478,919,8546,77.521614,87.2691,2003,72.26773,1748,38,808,516,1076,4236,6176,7.5247526,833,505,16.17647,"308051533",63.11208,1388
657,2018,1067,442,290,74.529236,60.382515,226,"Gladstone",1504,60.121765,4388,54,2080,732,2308,61.64067,59.064327,388,3749,70.34814,80.050186,797,68.578285,638,28,395,202,586,1731,2571,8.0229225,342,349,18.62069,"308051534",58.24742,833
1344,3712,2172,976,575,81.33082,66.80356,373,"Gladstone Hinterland",3019,62.5,8117,120,3830,1461,4287,65.67886,56.97211,606,7019,76.564415,86.585365,1476,73.956406,1278,70,840,286,1248,3307,5191,13.384321,502,523,20.869566,"308051535",61.551155,1630
408,1234,760,350,148,79.659645,69.16996,146,"Kin Kora - Sun Valley",983,68.13725,2658,30,1276,506,1382,67.85714,56.796116,252,2354,79.503105,84.76954,499,74.04418,423,15,278,117,384,1120,1743,9.615385,206,156,20.27027,"308051536",57.93651,483
0,0,0,0,0,0.0,0.0,0,"South Trees",0,0.0,0,0,0,0,0,0.0,0.0,0,0,0.0,0.0,0,0.0,0,0,0,0,0,0,0,0.0,0,0,0.0,"308051537",0.0,0
658,1907,1288,610,206,79.286835,66.23235,255,"Telina - Toolooa",1512,62.00608,4278,23,2165,921,2113,65.34754,64.03061,403,3878,77.10487,86.094315,827,72.20216,712,19,408,251,522,1971,2800,9.793815,392,194,11.165049,"308051538",63.275433,677
687,1420,991,366,487,74.85915,68.41122,172,"Kadina",1063,62.445415,3955,71,2048,535,1907,66.28763,56.776558,297,2915,66.61392,81.262726,491,70.46312,399,41,429,155,421,1495,2054,7.414105,273,553,14.579056,"405041124",57.912457,632
532,1531,858,361,291,72.7629,62.67361,144,"West Gladstone",1114,56.76692,3516,35,1694,576,1822,61.904762,56.47482,286,2917,69.90595,80.560135,607,67.6037,489,38,302,157,446,1386,1972,12.337663,278,308,12.027492,"308051539",50.34965,638
1054,2287,1806,737,665,85.13336,80.02171,246,"Broadbeach Waters",1947,65.74953,6065,139,3113,921,2952,75.62814,68.523,409,4675,78.470825,88.46154,884,80.278076,782,93,693,283,780,2388,3753,12.827586,413,725,20.902256,"309011224",60.146698,994
915,1794,1389,490,534,89.13043,75.38461,178,"Barossa - Angaston",1599,70.382515,4691,151,2363,650,2328,74.83836,57.044674,300,3650,82.32662,89.0,600,81.863014,534,89,644,166,736,1856,2988,17.554241,291,507,28.277153,"405011110",59.333332,894
1242,2728,2001,764,631,83.54105,73.39097,279,"Light",2279,70.20934,6758,174,3399,1041,3359,72.08213,54.563896,522,5504,77.63878,89.859764,927,77.76163,833,96,872,269,993,2776,4280,15.409309,493,623,27.575277,"405011111",53.448277,1279
864,1857,1384,541,431,85.89122,78.862976,211,"Lyndoch",1595,70.02315,4588,91,2300,686,2288,73.49973,56.156155,364,3740,84.41558,89.47369,646,79.652405,578,51,605,187,715,1883,2979,12.230216,333,417,21.11369,"405011112",57.967033,847
1085,2520,2138,995,761,85.59524,82.02803,261,"Burleigh Heads",2157,69.95392,6905,129,3624,1213,3281,79.03882,72.481575,384,5225,75.7513,88.47139,1171,82.20096,1036,89,759,295,731,2705,4295,9.68444,407,919,16.95138,"309011225",67.96875,965
845,1818,1413,559,641,87.34873,77.74687,196,"Nuriootpa",1588,70.53255,5149,109,2690,719,2459,74.643425,59.574467,331,3711,83.730156,88.91929,731,80.86769,650,62,596,196,633,1893,3001,7.779172,329,797,17.00468,"405011114",59.2145,756
302,686,503,169,200,91.69096,77.16895,61,"Le Hunte - Elliston",629,79.80132,1659,57,773,219,886,83.140495,61.904762,85,1291,79.72973,93.50649,231,87.68397,216,41,241,52,295,605,1132,24.404762,84,168,28.5,"406011132",71.76471,370
1745,3839,3368,1502,1229,84.787704,82.34649,446,"Burleigh Waters",3255,71.97707,10889,160,5821,1824,5068,79.28437,73.343155,694,8087,77.93427,89.90327,1654,81.89687,1487,112,1256,498,1162,4248,6623,7.1201525,679,1573,13.018714,"309011226",64.26513,1491
1272,3840,3154,1587,817,87.34375,82.91536,467,"Mermaid Beach - Broadbeach",3354,69.96855,9504,167,4847,1914,4657,79.868324,74.31193,625,7789,77.608345,89.02997,1969,83.55373,1753,110,890,567,967,3949,6508,12.249443,763,898,20.440636,"309011227",74.72,1246
452,1049,678,243,280,84.17541,72.537315,95,"West Coast (SA)",883,73.00885,2444,73,1115,335,1329,75.08305,59.482758,144,1952,74.5946,86.0,350,79.96926,301,36,330,69,414,903,1561,16.981133,116,212,26.071428,"406011134",65.97222,555
723,1620,1222,514,406,80.679016,70.701515,198,"Mount Warren Park",1307,65.00691,4303,55,2277,727,2026,68.42105,57.440475,334,3406,79.52,84.266266,661,74.25132,557,45,470,193,497,1786,2529,9.164969,336,491,13.546798,"311021309",59.281437,625
1121,2278,1793,622,565,85.16242,75.21161,282,"Worongary - Tallai",1940,70.29438,5849,136,3006,827,2843,75.27288,68.43318,472,4660,81.87794,87.7193,741,80.1073,650,86,788,297,872,2382,3733,13.782051,434,624,24.070797,"309061250",59.74576,1065
1504,3543,2825,1232,999,84.19418,77.338356,409,"Mermaid Waters",2983,67.15426,9473,174,4931,1593,4542,75.7779,69.88907,647,7271,75.84906,88.79694,1571,79.878975,1395,142,1010,441,1005,3728,5808,11.803823,631,1203,17.417418,"309011228",63.214836,1325
1748,3971,2475,1016,1007,73.10501,64.426125,408,"Lowood",2903,56.52174,9931,168,4953,1577,4978,60.88561,51.62162,792,8036,67.10817,81.27286,1367,66.92384,1111,89,988,382,1216,4065,5378,10.022523,740,888,16.683218,"310021281",51.515152,1812
1589,3761,2407,863,823,75.72454,71.26342,459,"Rosewood",2848,65.44997,8875,163,4291,1211,4584,69.366,60.597015,777,7231,74.299934,74.94553,1377,72.67321,1032,98,1040,406,1194,3470,5255,11.936663,670,821,19.80559,"310021282",59.07336,1607
766,1711,1234,531,682,76.73875,79.3722,188,"Coolangatta",1313,59.660576,4801,74,2408,669,2393,71.41204,69.62457,253,3439,61.787563,83.67347,686,74.062225,574,42,457,204,477,1728,2547,6.1764708,293,680,10.85044,"309021230",74.308304,772
492,953,646,237,326,75.97062,75.0,100,"Port Pirie Region",724,63.821136,2553,52,1274,316,1279,68.28753,49.275364,184,1899,69.62306,81.13207,318,72.143234,258,27,314,68,314,946,1370,8.231708,138,328,15.95092,"405031123",54.347828,451
1275,2545,2096,777,782,82.239685,77.39044,321,"Currumbin Waters",2093,72.54902,7042,107,3715,1004,3327,75.9971,64.30063,539,5303,79.48718,87.542854,875,78.99302,766,86,925,308,899,2758,4189,8.986416,479,957,13.682864,"309021232",59.55473,1131
761,2160,1833,1004,409,84.90741,84.22819,206,"Miami",1834,68.46255,5381,73,2812,1192,2569,79.55729,74.643875,306,4464,74.89598,89.585175,1133,82.14606,1015,46,521,262,540,2304,3667,9.055119,351,508,17.848412,"309011229",67.32026,721
839,1974,1697,794,391,84.14387,78.61386,244,"Merrimac",1661,71.27533,5126,79,2761,1010,2365,74.98895,62.801933,424,4237,79.880775,91.24004,879,79.25419,802,45,598,260,536,2263,3358,9.036144,414,498,20.204603,"309081260",57.54717,671
1531,3216,2678,1175,878,81.96517,79.66102,348,"Currumbin - Tugun",2636,67.08034,8579,135,4485,1475,4094,76.05794,70.87379,544,6737,73.88724,87.3867,1324,78.87784,1157,111,1027,365,996,3521,5314,11.514523,515,964,15.375854,"309021231",63.97059,1348
465,1611,961,503,201,73.49472,68.904106,167,"Darra - Sumner",1184,53.11828,3545,30,1733,730,1812,63.93879,59.74026,317,3114,64.6,83.627205,794,68.88247,664,27,247,184,323,1503,2145,11.73913,308,230,14.925373,"310011271",52.68139,500
834,2249,1438,694,496,71.76523,65.59547,198,"Durack",1614,58.27338,5863,58,3118,1058,2745,60.26823,43.522266,458,4635,66.3354,83.56998,986,65.84682,824,43,486,215,534,2386,3052,5.874317,494,732,11.693548,"310011272",43.23144,805
1660,3402,2701,1016,1043,83.597885,75.31505,441,"Elanora",2844,70.96385,9309,173,4864,1349,4445,74.59265,65.68627,733,7023,79.199425,88.34646,1270,78.954865,1122,105,1178,402,1108,3621,5545,8.447305,612,1243,16.58677,"309021233",60.16371,1399
1092,2531,1956,839,591,77.67681,71.709404,307,"Biggera Waters",1966,63.919415,6710,108,3588,1170,3122,69.3617,63.62007,542,5351,74.057144,81.05924,1114,73.29471,903,64,698,355,648,2820,3922,8.333333,558,768,18.27411,"309031236",56.642067,875
918,1883,1522,604,321,86.6171,78.85117,190,"Karana Downs",1631,76.90632,4502,84,2298,766,2204,75.910225,56.074768,345,3888,85.180725,91.80791,708,81.09568,650,32,706,180,707,2005,3153,10.921502,321,293,26.168224,"310031290",55.072464,830
816,2102,1209,526,354,65.55661,53.346855,245,"Leichhardt - One Mile",1378,51.593136,5170,44,2714,986,2456,52.315014,45.972496,513,4413,62.32687,73.70242,867,58.622253,639,28,421,234,450,2311,2587,6.9478908,509,403,12.429379,"310031291",47.758286,722
1831,4339,3550,1640,1056,81.74695,79.07425,445,"Palm Beach",3547,69.47024,11330,153,5935,2074,5395,75.822296,67.696266,719,9021,74.55621,87.512955,1930,78.67199,1689,112,1272,526,1260,4682,7097,8.938547,777,1253,14.488636,"309021234",61.891518,1690
0,0,0,0,0,0.0,0.0,0,"Lake Manchester - England Creek",0,0.0,0,0,0,0,0,0.0,0.0,0,0,0.0,0.0,0,0.0,0,0,0,0,0,0,0,0.0,0,0,0.0,"310021279",0.0,0
1337,2972,2300,875,808,80.01346,71.89811,388,"Arundel",2378,70.231865,7918,113,4138,1217,3780,71.51741,60.574017,722,6188,81.82587,85.19213,1067,75.59793,909,85,939,401,968,3216,4678,9.219089,662,922,13.985148,"309031235",53.739613,1183
2071,5262,3359,1455,1181,71.07564,65.570076,569,"Ipswich - East",3740,59.246742,13314,110,6871,2219,6443,62.726425,53.521126,1063,10617,67.41742,77.873695,2201,66.86446,1714,107,1227,570,1347,5355,7099,7.0580473,1065,1516,9.31414,"310031287",53.527752,1998
797,1727,1406,553,275,85.176605,81.20411,191,"Karalee - Barellan Point",1471,75.15684,4068,52,2066,681,2002,77.636665,67.267265,328,3538,85.52972,90.56,625,81.31713,566,30,599,224,662,1811,2877,11.764706,333,255,18.90909,"310031289",58.23171,774
1307,2437,2039,825,1206,79.2778,72.687225,207,"Coombabah",1932,62.89212,8112,131,4469,1135,3643,71.219,61.99525,397,5300,72.30465,83.867836,1029,74.92453,863,131,822,261,731,2863,3971,8.156912,421,1606,10.862355,"309031237",52.141056,1011
832,2136,1512,618,308,77.855804,73.65912,299,"Molendinar",1663,66.82692,4952,90,2508,839,2444,69.26248,56.640625,552,4319,78.55297,82.22222,810,73.51239,666,48,556,290,608,2183,3175,14.769231,512,325,29.22078,"309091264",54.166668,774
2252,5258,3875,1595,1383,73.240776,67.38487,590,"Labrador",3851,62.38899,14172,173,7531,2367,6641,67.780304,63.843353,1051,10975,65.948715,79.8405,2257,70.396355,1802,174,1405,701,1286,5717,7726,9.592062,1098,1814,12.509038,"309031238",56.137012,1950
1683,3540,2977,1178,1006,84.63277,76.99346,423,"Carrara",2996,71.71717,9461,184,4915,1530,4546,76.529564,68.9808,668,7430,78.63946,87.94579,1402,80.39031,1233,125,1207,467,1156,3890,5973,12.195122,677,1025,18.290258,"309061246",63.323353,1470
1353,2272,1888,636,1213,85.82746,74.82353,212,"Runaway Bay",1950,65.4102,7397,205,3912,850,3485,73.34888,64.15094,367,4846,76.397514,86.37532,778,79.19934,672,129,885,238,861,2574,3838,9.641255,371,1338,16.900248,"309031240",57.765667,1127
1113,2469,1980,821,613,83.515594,77.45283,286,"Highland Park",2062,70.26056,6380,106,3298,1060,3082,74.85822,66.10169,494,5114,79.77642,89.303734,991,79.03793,885,65,782,312,785,2645,4042,9.954059,472,653,17.292007,"309061247",57.894737,984
2523,5946,4548,2014,1444,79.68382,74.56498,635,"Nerang - Mount Nathan",4738,66.62703,15420,223,8030,2701,7390,71.6559,60.373997,1111,12293,73.90192,86.2249,2490,75.538925,2147,175,1681,678,1733,6347,9286,10.398099,1123,1683,15.443213,"309061248",57.155716,2345
1438,2518,2097,747,1122,87.609215,78.219894,239,"Paradise Point - Hollywell",2206,65.9249,7588,239,3948,955,3640,75.431656,63.307495,416,5298,78.107895,88.57837,823,81.21933,729,157,948,245,999,2780,4303,13.441781,387,1168,21.301249,"309031239",57.451923,1279
660,1270,961,352,308,84.40945,66.041275,108,"Guanaba - Springbrook",1072,69.242424,3248,75,1670,533,1578,69.84012,51.912567,174,2646,79.07324,84.309135,427,76.832954,360,57,457,95,529,1376,2033,19.387754,183,294,24.350649,"309041241",62.068966,669
2178,3905,3103,1064,1270,82.94494,75.46099,354,"Tamborine - Canungra",3239,69.05418,10651,269,5476,1410,5175,73.951385,60.19737,656,8101,77.8335,84.780876,1255,78.28663,1064,169,1504,366,1552,4196,6342,13.203125,608,1280,21.181103,"309041242",53.963413,1994
1085,2098,1671,559,541,83.88942,75.84803,252,"Currumbin Valley - Tallebudgera",1760,72.258064,5373,130,2734,737,2639,76.12756,67.29223,419,4293,78.46154,87.94992,639,79.9208,562,77,784,251,816,2195,3431,14.285714,373,539,24.029575,"309051243",60.1432,1040
2418,5277,4353,1803,1106,85.42732,76.85422,614,"Mudgeeraba - Bonogin",4508,71.71216,13230,255,6847,2346,6383,75.50737,65.43456,1071,11042,82.868706,90.61554,1982,80.248146,1796,161,1734,655,1843,5765,8861,14.879852,1001,1082,23.056057,"309051244",57.329597,2224
2009,5684,4306,2097,603,83.72625,73.994354,742,"Pacific Pines - Gaven",4759,70.48283,12928,112,6641,2834,6287,71.27959,59.933224,1293,11725,86.20507,90.9964,2499,77.31343,2274,75,1416,718,1631,6041,9065,12.5,1198,600,18.573797,"309061249",57.385925,1892
1205,2915,2082,717,417,77.73585,72.57085,441,"Parkwood",2266,74.10789,6709,108,3377,988,3332,70.6721,55.776894,846,5861,82.38007,83.65482,985,74.185295,824,52,893,420,893,2946,4348,12.064965,753,431,25.89928,"309091265",52.12766,1084
1174,3913,2932,1467,281,83.89982,68.58345,539,"Coomera",3283,70.10221,8783,77,4589,2139,4194,68.392815,61.293636,844,8200,83.510635,88.87172,1941,75.79269,1725,45,823,597,942,4287,6215,14.900662,974,302,27.402136,"309071251",63.86256,1128
2329,5007,3921,1521,1178,82.42461,77.800514,642,"Helensvale",4127,71.61872,12879,204,6694,1955,6185,74.65727,60.330578,1120,10259,81.97647,87.343925,1762,78.44819,1539,148,1668,584,1742,5252,8048,10.263523,968,1442,17.317488,"309071252",57.32143,2125
1606,2966,2395,864,1193,87.82873,76.5279,289,"Hope Island",2605,64.508095,8643,253,4484,1129,4159,72.57576,60.707966,500,6266,80.257805,88.70968,992,79.79572,880,152,1036,343,1183,3300,5000,12.837838,565,1184,21.20704,"309071253",57.8,1474
518,1180,782,303,313,83.98305,77.099236,121,"Jacobs Well - Alberton",991,66.02316,2821,67,1328,393,1493,72.54174,63.473053,182,2258,76.35468,86.88946,389,78.52081,338,31,342,106,465,1078,1773,12.4,167,250,21.40575,"309071254",66.48351,609
2008,5827,4475,2246,850,85.60151,76.290764,713,"Ormeau - Yatala",4988,71.81275,13614,162,6937,2944,6677,73.68681,61.37377,1189,11900,84.16453,91.94207,2693,79.52101,2476,99,1442,688,1637,6073,9463,11.458333,1121,864,19.058823,"309071255",59.96636,1945
1936,4797,3791,1751,743,85.01147,77.649666,558,"Oxenford - Maudsland",4078,71.12603,11467,139,5927,2255,5540,73.54025,59.751038,939,9952,83.69265,91.117615,2049,79.069534,1867,87,1377,576,1514,5155,7869,11.26943,964,772,18.707941,"309071256",59.42492,1809
648,2529,1915,1022,236,82.75999,67.016396,371,"Pimpama",2093,66.512344,5880,49,3115,1525,2765,66.10287,59.80663,556,5426,76.43098,88.39739,1379,73.86657,1219,29,431,433,454,2897,4008,13.302752,724,218,20.762712,"309071257",66.726616,594
2909,9325,7073,3688,1011,83.817696,74.25005,1162,"Upper Coomera - Willow Vale",7816,69.57717,21220,213,10884,4967,10336,71.55286,61.07516,1982,19210,83.13641,90.52747,4550,77.50651,4119,134,2024,1227,2322,9885,14889,13.413413,2009,999,21.068249,"309071258",58.627647,2793
602,1088,851,277,476,82.444855,75.271736,121,"Clear Island Waters",897,64.1196,3297,88,1733,368,1564,70.56385,63.135593,230,2294,77.50472,84.49848,329,76.19878,278,39,386,149,410,1206,1748,7.4003797,236,527,18.487394,"309081259",52.608696,529
680,1194,762,246,725,71.10553,68.14404,129,"Moonta",849,56.32353,3879,60,1960,361,1919,62.923203,54.705883,190,2405,59.242424,78.19768,344,66.98545,269,40,383,93,391,1211,1611,5.340454,170,749,8.275862,"405041125",67.89474,660
3019,6798,5462,2148,1729,81.803474,73.78908,882,"Robina",5561,70.75191,18083,360,9556,2911,8527,72.32521,57.953144,1632,14350,81.82917,85.2459,2684,76.81533,2288,238,2136,940,2031,7552,11023,11.876247,1622,2004,20.821283,"309081261",54.044117,2482
638,1317,1101,404,361,85.80106,77.842,151,"Bundall",1130,72.57053,3483,98,1805,519,1678,77.58985,63.35878,278,2736,82.22222,88.10573,454,81.5424,400,68,463,166,481,1419,2231,17.616581,262,386,27.146814,"309101268",54.316547,585
590,1055,647,190,630,73.175354,70.1107,73,"Yorke Peninsula - South",772,58.305084,3252,87,1567,271,1685,65.61866,51.2,148,2041,61.16208,83.794464,253,69.52474,212,49,344,64,400,986,1419,8.433735,125,581,13.809524,"405041128",49.324326,654
298,686,590,245,177,85.131195,78.025475,98,"Ceduna",584,73.8255,1799,49,936,314,863,78.666664,65.94203,155,1436,79.411766,85.328186,259,81.754875,221,34,220,91,216,750,1174,18.27957,138,186,27.683617,"406011129",63.225807,272
899,1838,1310,483,661,85.038086,77.52809,162,"Eyre Peninsula",1563,68.965515,4910,142,2411,623,2499,74.26304,54.545456,273,3602,75.20492,89.134125,589,79.761246,525,75,620,132,734,1764,2873,11.591963,242,647,21.482603,"406011130",59.34066,976
537,1199,864,325,414,91.1593,79.462105,122,"Kimba - Cleve - Franklin Harbour",1093,73.370575,3133,102,1520,409,1613,78.832115,60.666668,179,2295,79.771614,93.3661,407,85.27233,380,54,394,91,489,1096,1957,12.735849,150,424,24.637682,"406011131",68.156425,613
1748,4472,3716,1699,693,78.5331,73.16968,561,"Varsity Lakes",3512,68.53547,11275,117,6110,2322,5165,70.23247,59.049957,1079,9763,81.48426,84.847015,2059,74.03462,1747,98,1198,721,1087,5291,7228,11.965812,1221,819,16.883118,"309081262",51.992584,1334
1505,3338,2659,1068,947,82.77412,75.15834,411,"Ashmore",2763,71.42857,9144,183,4859,1421,4285,74.17015,60.546284,686,6923,77.94985,85.80247,1296,78.31865,1112,117,1075,399,1057,3585,5422,9.183674,659,1274,19.324183,"309091263",59.912537,1356
1969,4574,3332,1358,1237,77.35024,75.61247,526,"Port Lincoln",3538,68.76587,11760,180,5949,1796,5811,72.70347,62.958435,840,9157,70.939285,81.0736,1807,75.024574,1465,105,1354,515,1367,4583,6870,7.6866765,818,1366,14.551333,"406011133",62.61905,1927
1391,4685,3000,1366,1010,67.47065,65.26517,584,"Southport - North",3161,58.806614,11898,94,6203,2093,5695,60.655075,48.42681,1210,9631,63.607594,75.93849,2211,63.970512,1679,108,818,708,804,4946,6161,8.591886,1462,1257,9.306931,"309091540",48.26446,1264
1793,5117,2433,1181,808,56.79109,51.86649,492,"Inala - Richlands",2906,40.379253,12328,69,6403,2277,5925,45.42569,36.780716,1303,10473,52.26782,70.18349,1962,50.978706,1377,55,724,473,968,5356,5339,5.253104,1286,1047,8.539604,"310011274",37.759018,1852
491,1030,796,268,431,90.97087,77.0115,114,"Kingston - Robe",937,71.2831,2903,123,1442,348,1461,81.4739,69.565216,159,2007,74.90421,88.53868,349,86.347786,309,82,350,96,391,977,1733,17.634409,138,465,28.538282,"407021151",71.69811,522
1932,5012,3606,1570,1314,75.4589,70.026764,566,"Southport - South",3782,64.02692,13341,216,7015,2242,6326,68.127716,55.406612,1092,10305,71.03289,80.88706,2187,71.69335,1769,179,1237,620,1231,5293,7388,10.39489,1119,1722,16.438356,"309091541",51.8315,1733
1225,2343,1919,653,699,84.54972,73.37079,245,"Benowa",1981,70.53061,6461,172,3419,890,3042,72.55199,56.226414,487,4988,82.23684,86.99495,792,78.18765,689,104,864,298,875,2645,3900,13.436692,530,774,24.60658,"309101267",50.30801,1064
2518,5750,3590,1362,1538,69.49565,63.94366,588,"Lockyer Valley - East",3996,59.729946,14542,236,7254,2130,7288,62.02488,50.964912,1178,11538,67.61249,71.44893,2105,65.74796,1504,143,1504,581,1668,5788,7586,9.754434,1140,1466,15.344604,"310021280",49.91511,2467
554,1046,872,331,489,93.30784,78.99761,84,"Main Beach",976,65.34296,3075,138,1540,419,1535,78.41727,69.78417,131,2158,77.1855,87.89238,446,85.63485,392,82,362,97,362,1112,1848,19.158878,139,428,28.22086,"309101269",64.12214,469
2393,7552,5161,2414,1775,80.19068,72.73275,907,"Surfers Paradise",6056,63.142498,18396,395,9069,3319,9327,70.81504,62.944164,1481,14840,72.26028,82.088356,3735,75.58625,3066,244,1511,992,1688,7288,11217,13.700169,1576,1781,22.253521,"309101270",61.242405,2336
642,1499,1153,444,230,81.32088,79.42755,200,"Ipswich - North",1219,74.92212,3451,43,1722,559,1729,75.656166,63.77709,347,3023,80.35427,89.830505,531,78.4651,477,22,481,206,499,1524,2372,11.111111,323,198,18.695652,"310031288",57.636887,621
1151,4786,3877,2351,233,85.72921,76.55487,600,"Springfield Lakes",4103,74.80452,10554,51,5535,3071,5019,74.045074,62.327415,987,10022,86.50138,92.61993,2710,79.624825,2510,33,861,632,942,5236,7980,11.036789,1014,299,21.888412,"310041304",60.79027,1089
1754,3800,2507,926,1218,75.10526,63.381245,399,"Beaudesert",2854,60.661346,10280,223,5262,1461,5018,63.308083,50.872482,735,7760,71.7025,74.25595,1344,69.08505,998,138,1064,379,1234,3960,5361,10.599078,745,1302,18.308702,"311011305",54.285713,1721
2599,5888,4870,2033,1600,80.94429,79.631805,560,"Unley - Parkside",4766,73.52828,16250,321,8762,2553,7488,76.47613,57.31908,1205,12256,79.939606,85.91966,2365,78.62272,2032,229,1911,697,1853,6368,9636,9.56558,1216,2394,20.0625,"401071024",46.47303,2318
3381,8589,6585,3052,1072,80.48667,73.59537,986,"Forest Lake - Doolandella",6913,71.014496,20308,216,10647,4147,9661,70.39017,54.898743,1921,17944,82.25371,88.36393,3704,75.222916,3273,129,2401,1003,2438,9355,13498,9.98452,1827,1292,20.149254,"310011273",51.327435,2964
0,0,0,0,0,0.0,0.0,0,"Carole Park",0,0.0,0,0,0,0,0,0.0,0.0,0,0,0.0,0.0,0,0.0,0,0,0,0,0,0,0,0.0,0,0,0.0,"310041298",0.0,0
941,2575,1715,771,311,77.00971,65.78498,315,"Collingwood Park - Redbank",1983,64.399574,5955,50,3069,1172,2886,63.897167,53.415062,574,5259,74.54751,85.854965,1117,70.31755,959,33,606,305,659,2684,3698,8.571428,571,385,16.077171,"310041299",54.878048,884
961,3105,1703,869,428,66.666664,58.361317,335,"Goodna",2070,51.612904,7189,68,3656,1489,3533,53.469387,41.088436,738,6290,63.211384,75.56038,1383,59.9841,1045,36,496,302,622,3185,3773,7.643312,735,471,15.887851,"310041300",45.392956,984
756,2389,1836,990,385,80.45207,80.750404,234,"Oxley (Qld)",1922,69.57672,5697,46,2923,1226,2774,76.08786,64.037125,430,4802,77.42782,87.88638,1197,78.259056,1052,44,526,276,590,2413,3758,8.627451,431,510,11.948052,"310011275",54.418606,762
340,3428,338,167,199,14.49825,28.25719,85,"Wacol",497,29.705883,4959,14,1332,591,3627,27.980133,22.743683,708,4636,20.536913,12.405064,1975,18.011217,245,7,101,63,153,1208,835,5.645161,277,124,7.035176,"310011276",12.00565,745
1614,3260,2471,874,1161,84.32516,72.29115,362,"Boonah",2749,66.41884,8989,270,4568,1209,4421,72.740654,63.588852,580,6657,74.1488,86.014626,1094,78.4137,941,160,1072,365,1176,3397,5220,13.663535,574,1171,23.255814,"310021277",62.41379,1586
780,1295,802,247,674,68.03089,60.243904,86,"Esk",881,52.94872,3985,93,2016,410,1969,57.864357,43.367348,191,2681,60.593792,69.69697,363,62.775085,253,57,413,85,449,1386,1683,9.047619,196,630,13.79822,"310021278",45.026176,741
1155,3056,2264,1018,618,74.018326,68.459984,383,"Brassall",2262,63.722942,7898,74,4224,1487,3674,66.19883,58.868896,732,6476,70.701935,82.77405,1341,69.88882,1110,52,736,458,695,3420,4526,6.467662,778,804,11.97411,"310031283",52.322403,983
1005,2788,1659,735,532,71.34146,64.417175,311,"Bundamba",1989,58.10945,6598,55,3278,1141,3320,61.217712,52.48227,597,5498,68.19484,79.45804,1144,66.3514,909,44,584,296,714,2710,3648,7.746479,564,568,10.338346,"310031284",52.093803,1047
748,2060,1509,673,320,82.135925,69.88577,298,"Churchill - Yamanto",1692,70.721924,4907,46,2527,963,2380,69.37931,59.698277,464,4235,78.9781,88.58398,911,75.58442,807,30,529,277,541,2175,3201,8.522727,464,352,14.375,"310031285",64.22414,685
828,2062,1259,503,399,67.361786,68.249664,223,"Ipswich - Central",1389,61.47343,4968,50,2507,737,2461,62.450397,46.563194,490,4078,68.142685,74.04479,759,64.93379,562,37,509,210,554,2016,2648,7.5356417,451,491,12.531328,"310031286",45.510204,813
698,1818,1159,527,512,71.89219,65.875,179,"North Ipswich - Tivoli",1307,60.028652,4769,55,2439,800,2330,63.927193,56.50794,340,3631,67.441864,77.643906,747,67.91518,580,35,419,178,493,1813,2466,5.5910544,315,626,10.742188,"310031292",52.64706,731
783,2243,1598,776,294,79.937584,66.72399,298,"Edens Landing - Holmview",1793,66.538956,5344,44,2807,1163,2537,65.17129,53.359684,483,4695,75.36232,87.009346,1070,72.22577,931,31,521,270,520,2452,3391,8.732394,506,355,14.965986,"311021308",61.697723,690
1646,4371,3163,1496,862,79.04369,70.56604,551,"Raceview",3455,64.03402,11013,97,5780,2120,5233,67.22636,58.785942,969,9076,76.67543,87.23404,1880,72.91759,1640,61,1054,552,1167,4705,6618,5.6744184,939,1075,11.2529,"310031293",56.862743,1522
486,1495,1234,601,133,87.35786,79.81408,230,"Ripley",1306,74.69136,3338,32,1710,753,1628,77.70781,73.0659,325,3083,82.47423,94.014595,685,82.38728,644,15,363,255,400,1588,2540,12.295082,349,122,24.06015,"310031294",70.76923,485
300,796,356,158,222,60.80402,47.590363,81,"Riverview",484,45.333332,2121,18,1103,332,1018,44.389027,30.588236,198,1598,58.032787,70.98976,293,52.56571,208,10,136,52,177,802,840,3.3222592,170,301,8.1081085,"310031295",40.909092,305
1313,4377,3274,1773,346,82.453735,77.32229,520,"Bellbird Park - Brookwater",3609,70.98248,9559,63,4836,2293,4723,72.755554,58.83669,907,8877,80.43155,91.48636,2126,77.53745,1945,43,932,526,1081,4500,6883,12.797619,894,336,18.208092,"310041296",57.331863,1344
1191,2974,1974,829,504,77.50504,72.02433,381,"Camira - Gailes",2305,65.40722,6861,80,3383,1151,3478,67.60274,57.785465,653,5894,76.03375,83.01057,1136,72.59925,943,32,779,334,901,2920,4279,6.911447,578,463,15.873015,"310041297",58.346096,1185
0,0,0,0,0,0.0,0.0,0,"New Chum",0,0.0,0,0,0,0,0,0.0,0.0,0,0,0.0,0.0,0,0.0,0,0,0,0,0,0,0,0.0,0,0,0.0,"310041301",0.0,0
0,0,0,0,0,0.0,0.0,0,"Buffalo Creek",0,0.0,0,0,0,0,0,0.0,0.0,0,0,0.0,0.0,0,0.0,0,0,0,0,0,0,0,0.0,0,0,0.0,"701021014",0.0,0
1620,5713,3484,1836,449,72.76387,62.640736,722,"Redbank Plains",4157,57.407406,12706,69,6544,2931,6162,57.472782,44.54004,1430,11775,70.70968,83.05891,2733,64.891716,2270,45,930,673,1096,6062,7641,9.3361,1511,482,15.367483,"310041302",50.48951,1550
711,2133,1646,814,152,83.26301,75.86207,278,"Springfield",1776,70.60478,4720,31,2435,1073,2285,72.831856,64.70588,491,4393,86.743515,91.24473,948,77.89665,865,22,502,308,602,2260,3422,12.571428,476,175,20.394737,"310041303",56.619144,694
844,2109,1404,602,430,78.33096,70.90695,232,"South Mackay",1652,65.28436,5154,53,2615,849,2539,67.30585,53.435116,385,4195,74.05213,84.318184,880,72.84863,742,41,551,210,625,2086,3056,7.7504725,393,529,12.325582,"312021356",60.25974,844
1083,2625,1843,709,496,87.27619,75.265396,311,"Walkerston - Eton",2291,71.37581,6053,129,2932,942,3121,74.0458,62.931034,482,5114,82.84983,90.62822,971,80.83692,880,69,773,292,971,2489,4134,15.575621,464,443,26.008064,"312021357",64.52282,1172
952,2540,1419,611,515,68.385826,60.019646,315,"Beenleigh",1737,54.936974,6116,59,3061,1018,3055,56.646706,47.28972,601,5045,65.180466,75.125374,997,62.556988,749,32,523,253,614,2505,3156,5.755396,535,556,11.45631,"311021306",52.412647,942
1382,3428,1989,859,1113,68.52392,54.40152,365,"Eagleby",2349,51.230103,9648,95,5107,1579,4541,53.082466,44.910942,753,7175,62.52059,77.344284,1461,60.45993,1130,69,708,353,759,3747,4338,5.0735292,786,1360,8.53549,"311021307",48.472775,1214
1208,2867,2215,886,508,82.66481,76.37931,324,"Gawler - North",2370,74.91722,6901,86,3526,1160,3375,75.0593,60.891937,587,5818,82.98045,89.44867,1052,78.80715,941,69,905,355,1019,2951,4585,12.0,583,575,16.929134,"402011025",55.19591,1228
2633,5683,4133,1534,1664,74.626076,70.56118,664,"Gawler - South",4241,67.67945,15387,173,8040,2174,7347,68.65449,58.532562,1270,11703,73.47625,81.41593,2034,71.554306,1656,107,1782,710,1748,6020,8374,5.2970295,1213,2020,10.396635,"402011026",52.283466,2379
795,1835,1257,479,309,79.50954,74.96088,203,"Lewiston - Two Wells",1459,69.0566,4207,62,2063,639,2144,70.97685,57.566765,356,3606,76.615746,86.30573,628,75.31892,542,35,549,194,652,1771,2716,11.986301,337,292,20.064724,"402011027",57.022472,851
800,1937,1477,589,338,84.20238,77.39816,271,"Wolffdene - Bahrs Scrub",1631,72.625,4582,60,2307,761,2275,75.05081,65.35626,444,3905,84.27835,90.097626,717,79.59027,646,41,581,266,654,1968,3108,12.094396,407,339,17.75148,"311021310",61.036037,776
338,1335,906,491,44,93.03371,80.09788,146,"Weipa",1242,87.27811,2573,21,1194,613,1379,78.714165,54.5,201,2486,93.47369,95.75114,659,86.40386,631,11,295,109,444,1151,2148,25.581396,200,43,47.727272,"315011403",72.63682,475
1429,3405,2265,984,906,76.651985,65.687584,428,"Boronia Heights - Park Ridge",2610,56.892933,9144,99,4833,1498,4311,62.088818,54.230236,767,7053,75.15873,82.43832,1378,69.11952,1136,77,813,391,947,3648,4875,6.4978905,721,1185,10.927153,"311031311",55.801826,1260
805,2254,1444,691,277,76.66371,64.159706,242,"Browns Plains",1728,58.136646,5271,43,2740,1077,2531,60.697773,51.307846,457,4633,74.41217,84.264435,1074,68.465355,905,30,468,255,538,2379,3172,8.310249,497,361,15.523466,"311031312",52.95405,723
657,1609,1123,416,276,82.47359,69.44908,250,"Chambers Flat - Logan Reserve",1327,69.10198,3759,56,1874,599,1885,69.10769,60.433605,367,3234,78.32586,86.73647,573,75.757576,497,30,454,223,524,1625,2450,12.048193,369,249,20.289856,"311031313",68.11989,669
1147,3492,2054,1020,352,72.45132,60.498222,429,"Crestmead",2530,55.536182,7858,62,4014,1686,3844,56.166256,44.17476,868,7149,72.26415,81.39386,1564,64.12086,1273,33,637,364,766,3657,4584,9.243697,824,357,17.613636,"311031314",49.42396,1060
0,0,0,0,0,0.0,0.0,0,"Greenbank Military Camp",0,0.0,0,0,0,0,0,0.0,0.0,0,0,0.0,0.0,0,0.0,0,0,0,0,0,0,0,0.0,0,0,0.0,"311031315",0.0,0
1042,2660,1871,787,405,80.67669,72.00366,351,"Hillcrest",2146,69.86565,6120,84,3055,1093,3065,70.074905,57.757008,617,5330,81.05907,86.239395,1061,75.36585,915,47,728,309,796,2670,4017,12.207792,535,385,20.74074,"311031316",56.88817,982
1292,3993,2383,1170,430,71.17455,59.090908,528,"Marsden",2842,57.043343,9208,65,4785,1980,4423,55.379967,41.804073,1069,8296,71.58703,80.479454,1752,62.98216,1410,45,737,431,839,4303,5225,9.3361,1031,482,15.116279,"311031317",49.391956,1172
699,1587,1071,371,255,81.47448,75.4065,211,"Munruben - Park Ridge South",1293,69.384834,3604,47,1762,492,1842,70.69307,57.71605,357,3102,82.26466,86.92153,497,76.2089,432,28,485,187,603,1515,2364,11.336032,324,247,18.431372,"311031318",59.10364,733
744,2015,1273,572,473,71.46402,60.915867,203,"Waterford West",1440,58.198925,5255,54,2767,939,2488,59.48598,49.015316,458,4155,69.4362,80.97395,883,65.29482,715,44,433,224,468,2140,2713,7.017544,457,627,11.416491,"311051328",44.323143,674
1998,5146,3692,1583,561,81.11154,71.114105,668,"Regents Park - Heritage Park",4174,68.96897,11638,94,5931,2226,5707,69.38545,61.07566,1164,10467,82.355995,88.807785,2055,75.150475,1825,61,1378,670,1587,5321,7866,10.0,1097,610,16.755793,"311031319",57.388317,1927
1673,4072,2981,1284,607,83.202354,76.06635,478,"Greenbank",3388,69.75493,9387,119,4708,1688,4679,71.46967,58.51852,827,8243,82.28141,90.25033,1518,77.26556,1370,56,1167,474,1421,4171,6369,10.428306,810,537,19.604612,"311041320",57.799274,1727
2939,7933,5802,2679,1006,82.74297,75.87086,1021,"Jimboomba",6564,69.61552,18031,202,9092,3531,8939,71.2164,58.735836,1736,16080,81.88153,89.90081,3327,76.902985,2991,92,2046,985,2350,8147,12366,9.73545,1677,945,20.079523,"311041321",58.813366,2870
1014,2801,2081,1034,889,78.47198,71.75572,365,"Bethania - Waterford",2198,62.524654,8036,85,4346,1441,3690,67.6748,56.935482,610,5876,72.01835,84.91281,1319,72.82165,1120,60,634,353,628,3075,4279,4.720692,620,1271,9.561305,"311051323",59.836067,872
996,2191,1561,568,446,83.20402,74.34555,271,"Logan Village",1823,68.8755,5194,82,2557,764,2637,71.935486,62.439026,449,4361,81.28286,88.11631,791,77.59688,697,51,686,256,773,2170,3384,13.178294,410,387,18.38565,"311041322",60.356346,951
311,925,711,359,213,82.810814,81.59091,92,"Higgins",766,73.3119,2312,26,1174,440,1138,76.04278,59.782608,165,1860,79.09091,90.0,430,79.4086,387,14,228,110,261,935,1477,5.8577404,184,239,12.206573,"801011014",55.757576,330
1260,2659,2187,811,520,86.61151,81.34403,387,"Cornubia - Carbrook",2303,74.20635,6532,112,3353,997,3179,78.19092,68.888885,556,5456,82.247,90.18143,937,82.29472,845,69,935,372,959,2797,4490,12.410072,540,556,21.538462,"311051324",69.60432,1166
1299,3436,2630,1265,560,83.44005,76.80631,423,"Loganholme - Tanah Merah",2867,68.283295,8131,92,4135,1647,3996,73.03527,62.137405,717,7037,81.825935,90.04525,1547,78.11568,1393,71,887,407,959,3601,5497,13.29588,655,534,16.428572,"311051325",58.995815,1172
1651,3869,3017,1195,622,85.47428,77.44653,508,"Shailer Park",3307,74.01575,9065,167,4574,1543,4491,76.302475,66.447365,813,7823,83.55899,88.77077,1505,80.838554,1336,95,1222,505,1296,3954,6324,15.32258,760,620,26.848875,"311051327",62.484623,1551
1111,3134,1897,841,423,71.21889,60.503597,412,"Loganlea",2232,58.235825,7298,76,3741,1390,3557,58.190186,47.95784,805,6394,68.19572,79.74777,1348,64.576164,1075,45,647,364,669,3260,4129,9.35551,759,481,17.966904,"311051326",51.180122,981
1095,3018,1423,595,481,62.624256,50.0,354,"Kingston (Qld.)",1890,47.21461,7044,58,3545,1190,3499,46.717007,36.53088,806,6064,63.45581,69.62656,1205,54.633904,839,33,517,278,639,3046,3313,6.6132264,761,499,12.058212,"311061330",43.920597,1007
581,1882,656,274,330,51.912857,37.845303,171,"Logan Central",977,40.791737,4325,37,2113,724,2212,37.57159,26.530613,516,3628,51.202747,60.07653,784,45.011024,471,28,237,117,298,1746,1633,7.629428,441,367,11.212121,"311061331",33.139534,582
1819,4653,3737,1787,974,85.64367,77.527115,510,"Rochedale South - Priestdale",3985,72.07257,11683,175,6056,2305,5627,75.28203,60.833332,878,9617,83.0032,90.542984,2210,80.29531,2001,128,1311,511,1299,4964,7722,11.721612,840,1092,17.967146,"311061332",58.08656,1565
889,2829,2116,1030,251,89.53694,73.30961,320,"Kalgoorlie - North",2533,79.077614,6118,81,3038,1405,3080,75.65248,65.80517,497,5626,88.4375,93.51312,1372,82.6342,1283,52,703,331,849,2797,4649,21.576763,503,241,32.270916,"511031280",64.386314,960
1138,3098,1787,831,555,69.91608,59.14591,340,"Slacks Creek",2166,54.393673,7534,77,3881,1405,3653,56.05395,40.930233,709,6286,67.439705,77.95576,1311,62.885777,1022,73,619,264,727,3188,3953,10.533911,645,693,13.873874,"311061333",47.954865,1078
1166,2817,2176,948,633,85.623,75.35771,330,"Springwood",2412,71.09777,7103,128,3653,1258,3450,73.78773,59.61905,554,5766,81.47087,90.54276,1216,79.56989,1101,86,829,313,853,2949,4588,12.215909,525,704,20.221169,"311061334",59.566788,1047
1129,2587,1765,733,771,79.28102,70.61657,313,"Bowen",2051,63.684677,6606,119,3248,1038,3358,69.05321,62.724937,491,5143,70.996445,84.46502,972,74.19794,821,69,719,244,798,2556,3816,9.971098,389,692,15.434501,"312011337",63.747456,1124
707,2702,1445,723,258,91.08068,68.20755,249,"Broadsound - Nebo",2461,67.75106,5241,88,2281,1060,2960,68.418564,58.550724,358,4814,86.158195,94.30577,1282,81.13834,1209,41,479,202,915,2112,3906,24.260355,345,169,34.10853,"312011338",69.55307,1062
350,1040,779,362,191,93.26923,74.79339,135,"Clermont",970,75.42857,2460,63,1229,484,1231,76.673225,63.186813,184,2056,86.76845,93.088554,463,85.06809,431,38,264,115,341,1016,1749,17.840376,182,213,32.984295,"312011339",73.36957,393
436,1012,642,245,286,83.794464,71.22093,102,"Collinsville",848,64.6789,2460,55,1162,344,1298,70.317635,56.390976,151,1925,74.6,88.088646,361,77.402596,318,40,282,75,373,913,1490,16.064257,133,249,19.23077,"312011340",67.54967,500
1370,2745,2351,858,683,85.82878,77.71739,340,"Toowoomba - East",2356,76.131386,7321,163,3893,1104,3428,76.98101,59.655174,574,5799,83.26217,87.8,1000,81.16917,878,104,1043,346,975,3054,4707,12.395709,580,839,23.8653,"317011457",59.233448,1171
1949,4786,3893,1677,615,80.526535,77.45959,688,"Kirwan - West",3854,73.88404,11313,91,5912,2165,5401,74.36485,62.80107,1135,10021,80.608795,87.639854,1877,77.307655,1645,72,1440,704,1430,5235,7747,10.635155,1121,677,14.796748,"318021482",60.61674,1774
1750,4519,3315,1457,757,79.79642,71.87962,536,"Andergrove - Beaconsfield",3606,66.51428,10917,90,5641,2027,5276,69.93671,64.07061,930,9259,77.24014,88.093994,1915,74.74889,1687,77,1164,617,1293,4740,6921,8.54606,963,901,11.889035,"312021342",57.634407,1674
633,2784,1756,984,96,92.31322,69.88636,309,"Moranbah",2570,71.248024,5420,37,2540,1408,2880,70.55042,69.64286,423,5273,91.207504,95.888596,1508,82.04058,1446,9,451,312,778,2489,4326,17.647058,448,51,38.541668,"312011341",73.049644,853
432,618,486,146,296,76.86084,73.0,28,"Magnetic Island",475,65.27778,1834,49,920,200,914,70.23122,51.666668,55,1310,66.13333,79.78723,188,73.35878,150,27,282,31,248,692,961,11.842105,60,228,16.554054,"318021483",50.909092,375
980,2977,2293,1145,335,83.170975,78.050446,458,"Mount Louisa",2476,70.0,6672,56,3360,1467,3312,75.22966,69.38436,703,6025,77.81494,91.793755,1377,79.15353,1264,45,686,417,698,3048,4769,14.423077,601,312,16.716417,"318021484",65.14936,897
1422,3192,2480,993,669,86.18421,76.20875,384,"Mount Pleasant - Glenella",2751,71.23769,7995,125,4134,1303,3861,74.251495,62.92683,641,6532,84.333824,91.98312,1185,80.08267,1090,87,1013,387,1152,3340,5231,10.957179,615,794,18.684605,"312021348",59.906395,1366
540,1630,1092,475,259,87.730064,72.40854,231,"Ooralea - Bakers Creek",1430,70.37037,3651,55,1762,656,1889,71.27937,65.47619,315,3162,82.2186,91.16809,702,79.75964,640,17,380,220,504,1532,2522,7.3913045,336,230,21.235521,"312021350",73.333336,613
916,2386,1588,723,449,86.92372,67.6333,246,"Pioneer Valley",2074,61.572052,5632,119,2797,1069,2835,66.00166,55.581947,442,4792,83.492065,92.092094,999,76.41903,920,67,564,234,789,2406,3662,17.13555,421,391,26.503342,"312021351",55.65611,945
1495,3462,2119,868,800,79.05835,66.92367,320,"Sarina",2737,57.926422,8353,131,4091,1297,4262,63.140644,52.304966,581,6818,74.12334,86.389565,1227,71.223236,1060,90,866,295,1226,3356,4856,12.244898,564,735,16.375,"312021352",55.077454,1654
1202,2452,1626,531,696,82.830345,70.05277,233,"Seaforth - Calen",2031,68.88519,6008,153,2860,758,3148,70.20725,55.33708,415,4768,77.692894,86.26373,728,76.69882,628,70,828,197,1017,2316,3657,12.867647,356,544,21.98276,"312021353",56.144577,1309
430,1071,743,314,254,80.95238,74.0566,130,"East Mackay",867,69.53488,2712,39,1387,424,1325,72.629524,59.763313,208,2094,76.47059,85.89109,404,76.886345,347,29,299,101,351,1023,1610,7.967033,169,364,15.354331,"312021343",62.5,459
682,1786,1153,495,440,76.09183,69.03766,224,"North Mackay",1359,62.7566,4534,52,2308,717,2226,66.57044,57.357357,372,3518,73.36123,79.91392,697,71.404205,557,39,428,191,526,1732,2512,6.7708335,333,576,11.818182,"312021349",60.215054,717
1335,3771,2831,1358,325,82.73667,72.23404,482,"Eimeo - Rural View",3120,69.51311,8431,68,4335,1880,4096,69.74625,60.900475,799,7830,81.26464,90.41987,1691,76.002556,1529,31,928,514,1041,4059,5951,11.231884,844,276,20.923077,"312021344",60.325405,1281
0,4,0,0,0,100.0,0.0,0,"Eungella Hinterland",4,0.0,4,0,0,0,4,0.0,0.0,0,4,100.0,0.0,0,100.0,0,0,0,0,4,0,4,0.0,0,0,0.0,"312021345",0.0,4
398,1226,668,312,185,68.923325,63.80368,115,"Mackay",845,58.0402,2704,30,1293,489,1411,62.546818,58.563538,217,2294,63.168724,75.1434,523,65.954666,393,19,231,106,307,1068,1513,8.444445,181,225,16.216217,"312021346",52.99539,486
697,1707,1247,561,223,82.7768,69.17386,190,"Shoal Point - Bucasia",1413,69.29699,3957,41,2027,811,1930,68.29134,57.54717,313,3533,82.65162,87.0073,685,75.29012,596,20,483,183,586,1826,2660,9.950249,318,201,18.38565,"312021354",60.702877,709
488,1002,688,266,200,77.145706,66.00496,107,"Slade Point",773,64.13934,2481,29,1279,403,1202,65.337135,53.703705,196,2055,77.77778,80.76923,338,71.09489,273,22,313,87,364,1053,1461,9.734513,162,226,14.5,"312021355",54.591835,468
574,1319,950,343,248,83.24488,76.73378,199,"Burpengary - East",1098,74.56446,3049,34,1482,447,1567,75.39683,70.292885,296,2579,82.46206,87.441864,430,79.41062,376,11,428,168,489,1260,2048,4.954955,239,222,13.709678,"313021364",67.22973,593
2833,7444,4764,2122,1662,70.20419,62.356743,879,"Caboolture",5226,55.66537,19019,153,9913,3403,9106,59.09937,53.47945,1617,15505,64.50499,78.01925,3221,64.43083,2513,89,1577,976,1681,8061,9990,4.8056154,1825,1852,9.205776,"313021365",54.359924,2606
2131,5586,3573,1626,1039,70.87361,57.47614,679,"Caboolture - South",3959,54.9038,14155,125,7530,2829,6625,56.48119,51.756954,1275,11912,67.23947,77.463104,2507,63.230354,1942,70,1170,707,1213,6326,7532,5.8139534,1366,1204,12.030799,"313021366",53.2549,1804
1757,3428,2417,931,994,73.80397,66.31054,312,"Margate - Woody Point",2530,62.720547,9257,121,4835,1404,4422,66.110504,59.39394,553,7084,68.313255,79.25926,1215,69.83343,963,90,1102,294,1134,3656,4947,7.633588,495,1179,12.173038,"313051378",56.41953,1660
528,1265,886,354,237,81.264824,75.64103,189,"Elimbah",1028,67.42424,2957,37,1455,468,1502,71.509285,61.31687,295,2504,78.35821,88.01843,434,76.4377,382,27,356,149,420,1239,1914,12.5,243,216,15.611814,"313021367",64.067795,536
1870,4346,3089,1214,816,79.5214,71.96206,638,"Burpengary",3456,65.5615,10584,90,5422,1687,5162,68.82799,63.58754,1027,8834,77.84884,86.86679,1599,74.088745,1389,57,1226,592,1339,4488,6545,6.1027837,931,934,11.029411,"313041372",62.12269,1720
2676,6120,3919,1572,1703,70.91503,61.622894,694,"Deception Bay",4340,56.98804,16354,142,8531,2551,7823,59.70445,52.804787,1361,12684,69.224525,78.35366,2296,65.113525,1799,116,1525,706,1705,6564,8259,5.8973055,1337,1967,8.338226,"313041373",50.991917,2463
0,0,0,0,0,0.0,0.0,0,"Kalgoorlie Airport",0,0.0,0,0,0,0,0,0.0,0.0,0,0,0.0,0.0,0,0.0,0,0,0,0,0,0,0,0.0,0,0,0.0,"511031281",0.0,0
509,1478,759,323,231,77.67253,61.64122,92,"Kambalda - Coolgardie - Norseman",1148,60.707268,3108,48,1399,524,1709,60.429935,48.430492,211,2734,75.872536,83.552635,608,69.75128,508,19,309,108,500,1256,1907,13.286714,223,143,20.77922,"511031282",43.601894,659
795,1567,1148,342,337,84.045944,76.0,244,"Morayfield",1317,69.308174,3796,60,1892,450,1904,72.337746,65.20468,369,3154,82.251656,88.48759,443,78.154724,392,32,551,223,621,1587,2465,10.491803,342,305,17.804153,"313041374",66.124664,755
1133,2418,1779,730,689,76.468155,75.41322,261,"Clontarf",1849,68.22595,6349,71,3242,968,3107,72.55302,60.11396,444,4870,70.62737,83.94794,922,74.49692,774,65,773,211,743,2452,3628,8.227848,351,790,10.30479,"313051377",58.783783,1052
716,1503,969,314,486,71.057884,64.47639,143,"Millicent",1068,64.385475,4017,66,2028,487,1989,66.46091,58.431374,294,2961,65.10067,80.60345,464,68.79433,374,45,461,149,485,1458,2037,7.894737,255,570,13.580247,"407021152",48.639454,745
1107,2731,2070,859,586,75.83303,70.17974,374,"Newtown (Qld)",2071,63.95664,7204,85,3887,1224,3317,66.55949,56.86778,610,5841,69.58291,81.54657,1138,70.89539,928,60,708,443,684,3110,4141,7.7220078,779,777,14.505119,"317011453",61.311474,983
1472,2724,1939,693,973,73.75184,67.41245,260,"Redcliffe",2009,59.91848,7940,112,4243,1028,3697,65.35221,58.67238,473,5691,67.52336,79.627716,967,69.372696,770,90,882,274,867,2967,3948,7.0532913,467,1276,11.510792,"313051379",54.96829,1284
2018,4442,3282,1330,1444,77.21747,67.27364,597,"Rothwell - Kippa-Ring",3430,62.636272,12859,147,6973,1977,5886,65.75836,58.232933,1002,9433,73.78299,82.30547,1735,71.15446,1428,108,1264,580,1258,4991,6712,5.4490414,996,1982,10.180056,"313051380",59.580837,1705
1924,3336,2650,870,1257,82.67386,75.12953,382,"Scarborough - Newport - Moreton Island",2758,66.42412,9767,213,5174,1158,4593,72.74225,65.062386,629,6979,76.38398,85.82755,1009,77.48961,866,137,1278,365,1297,3643,5408,8.9484,561,1531,16.945107,"313051542",60.73132,1698
896,1733,1070,332,795,73.97576,67.206474,147,"Mannum",1282,59.933037,4893,117,2365,494,2528,65.16444,50.0,278,3375,65.14227,80.042465,471,69.68889,377,75,537,126,641,1642,2352,10.373444,252,723,14.716981,"407031164",52.877697,984
1075,2603,2084,852,295,86.36189,81.60919,348,"Eatons Hill",2248,78.139534,5877,70,2979,1044,2898,78.05244,63.52087,593,5273,88.50046,94.04117,923,82.15437,868,42,840,350,962,2670,4332,13.592233,551,309,23.728813,"314011385",58.684654,1087
2884,7276,6053,2806,1435,85.63771,83.11611,854,"The Hills District",6231,76.0749,17798,244,9087,3376,8711,80.44923,68.35443,1411,14800,82.64523,91.78389,3128,83.0,2871,189,2194,864,2262,7524,12284,12.092131,1264,1563,17.003485,"314011386",60.524452,2737
455,1007,800,292,294,72.88977,76.24021,114,"Mundingburra",734,74.28571,2841,34,1540,383,1301,75.90133,62.5,251,2061,76.4411,78.71149,357,74.429886,281,35,338,135,305,1054,1534,7.2016463,216,486,11.564626,"318021485",45.418327,399
873,1747,1245,467,613,75.61534,65.58989,213,"Gympie - South",1321,58.762886,5016,73,2656,712,2360,64.10917,61.62465,366,3689,68.84817,82.49595,617,69.55814,509,45,513,220,526,1942,2566,6.302521,357,714,11.908646,"319031513",58.19672,764
2267,4870,4041,1487,949,86.078026,81.12384,672,"Albany Creek",4192,77.63564,12122,171,6303,1833,5819,79.297485,69.0763,1101,9966,86.3272,92.11165,1648,82.61088,1518,106,1760,688,1831,5096,8233,8.7821045,996,1207,18.018967,"314011382",61.035423,2121
2302,6083,4941,2264,663,86.89791,80.22679,851,"Cashmere",5286,74.54388,13832,147,7086,2822,6746,76.890755,67.97235,1316,12509,85.70128,93.58226,2571,81.75713,2406,76,1716,885,1882,6426,10227,11.515152,1302,660,22.171946,"314011383",64.66566,2196
1221,2541,1962,757,561,84.84849,79.10136,262,"Dayboro",2156,71.662575,6222,115,3120,957,3102,75.81144,61.951218,443,5129,81.10932,90.16393,854,80.28856,770,76,875,254,1009,2588,4118,14.285714,410,532,20.49911,"314011384",59.142212,1244
1906,3545,2816,913,786,85.38787,77.96755,421,"Samford Valley",3027,72.40294,8801,177,4470,1171,4331,74.97337,63.328423,723,7301,82.76441,91.78744,1035,80.030136,950,93,1380,430,1479,3756,5843,13.02521,679,714,22.519083,"314011387",58.2296,1787
2587,7216,5241,2465,1168,79.35144,69.94892,914,"Dakabin - Kallangur",5726,65.55856,17448,161,9064,3524,8384,68.09146,61.286255,1512,14913,74.906525,86.38156,3297,73.53986,2848,108,1696,972,1803,7697,10967,7.900512,1586,1367,13.784246,"314021388",60.449734,2407
478,1355,736,339,202,60.147602,54.066986,121,"Carpentaria",815,58.158997,3133,58,1576,627,1557,51.504547,30.246914,319,2784,64.39233,58.906525,567,55.71121,334,21,278,98,302,1429,1551,14.285714,324,147,28.712872,"315021404",37.931034,469
1608,3865,2966,1236,942,75.73092,73.70304,495,"Toowoomba - Central",2927,66.16915,10321,119,5514,1677,4807,70.484795,60.780064,835,8073,68.992805,82.560974,1640,72.99641,1354,105,1064,561,959,4208,5893,8.039816,923,1306,12.632696,"317011456",59.281437,1390
1743,5205,4180,2098,766,87.396736,75.98696,710,"Murrumba Downs - Griffin",4549,70.223755,12581,133,6610,2761,5971,73.734344,66.60944,1032,10874,83.95291,91.871826,2559,80.27405,2351,82,1224,776,1355,5669,8729,8.714134,1165,941,17.362925,"314021389",68.79845,1614
2752,8803,6955,3756,1034,85.72078,74.24392,1106,"North Lakes - Mango Hill",7546,70.639534,20803,163,10966,5059,9837,71.99048,62.54054,1822,18464,86.461075,92.04072,4322,78.53661,3978,98,1944,1157,2299,9661,14501,7.5095787,1850,1305,15.764023,"314021390",60.702526,2659
1449,2080,1644,465,1221,79.85577,69.81982,193,"Caloundra Hinterland",1661,60.04141,6974,202,3673,666,3301,68.5,54.035088,337,4480,69.91597,78.48101,553,73.77232,434,155,870,154,832,2400,3305,12.175962,285,1273,16.543816,"316061440",57.27003,1190
791,1698,1238,489,514,80.3298,74.65649,195,"Glass House Mountains",1364,65.23388,4484,66,2272,655,2212,70.10193,61.25,325,3464,78.40909,82.96041,581,75.11547,482,37,516,196,621,1766,2602,7.312253,320,506,12.840466,"316061441",60.0,792
1488,3088,2243,831,700,79.371765,70.96499,363,"Landsborough",2451,68.27957,7641,104,3853,1171,3788,69.96257,61.243145,621,6294,77.05754,84.64351,1094,74.578964,926,61,1016,335,1058,3206,4694,9.42813,547,647,14.857142,"316061442",58.454105,1373
1117,1618,1271,347,743,79.913475,68.44182,124,"Maroochy Hinterland",1293,62.130707,4965,130,2604,507,2361,67.462845,56.53846,224,3502,69.79937,84.56376,447,73.21531,378,83,694,147,661,1884,2564,11.527778,260,720,17.496635,"316061443",55.357143,947
1628,2980,2391,829,951,82.24832,73.88592,288,"Palmwoods",2451,70.8231,8091,174,4160,1122,3931,73.77353,62.729126,531,6221,77.524895,86.19367,1043,77.833145,899,101,1153,308,1090,3241,4842,10.990207,491,919,18.29653,"316061444",54.23729,1406
1055,2311,1850,840,728,83.03764,77.63401,237,"Bli Bli",1919,66.25592,6348,82,3309,1082,3039,73.32541,67.35751,368,4834,75.0792,89.25703,996,77.96856,889,51,699,260,711,2523,3769,6.4885497,386,786,11.263737,"316071545",64.402176,947
535,1017,776,272,372,84.36578,74.11444,116,"Diddillibah - Rosemount",858,67.66355,2850,61,1461,367,1389,72.38806,60.0,183,2089,78.28467,88.111885,286,78.219246,252,40,362,102,429,1072,1634,10.282776,170,389,16.39785,"316071546",63.387978,548
1620,3147,2259,782,828,78.99587,70.64137,274,"Eumundi - Yandina",2486,67.90124,7929,152,3954,1107,3975,70.48362,60.251045,529,6352,74.07643,85.591606,1048,74.70088,897,89,1100,288,1163,3205,4745,11.88251,478,749,18.357489,"316071547",51.79584,1570
1247,3109,2273,1055,522,79.800575,73.11157,358,"Bray Park",2481,63.993584,7533,78,3902,1443,3631,68.60851,58.90851,647,6422,76.561,87.82548,1421,74.02678,1248,53,798,367,797,3313,4754,8.998302,623,589,14.942529,"314031391",55.332302,1041
709,1854,1319,607,367,76.91478,74.02439,236,"Lawnton",1426,69.81664,4538,37,2317,820,2221,70.309166,53.31412,419,3730,74.69325,85.05747,783,73.59249,666,32,495,185,487,1876,2745,7.2562356,347,441,10.081744,"314031392",56.32458,652
3674,6100,4554,1467,2093,77.57377,71.421616,560,"Noosa Hinterland",4732,64.4257,16717,331,8524,2054,8193,68.79154,58.295963,1012,12720,71.354004,82.8509,1831,73.00314,1517,200,2367,520,2324,6620,9286,10.504202,892,1904,15.81462,"316081549",55.335968,3257
1160,2699,2093,922,418,82.51204,76.897415,309,"Petrie",2227,71.034485,6436,68,3319,1199,3117,73.25866,61.24498,511,5556,79.96237,88.888885,1125,77.75378,1000,42,824,305,850,2857,4320,9.090909,498,462,16.267942,"314031393",60.469666,1063
1402,3832,2649,1187,757,78.23591,69.41521,449,"Strathpine - Brendale",2998,65.83452,9384,110,4795,1710,4589,68.34365,59.816753,769,7708,75.33936,82.90156,1737,73.26154,1440,82,923,457,999,3876,5647,8.922742,764,919,14.531044,"314031394",58.387516,1326
138,393,103,53,29,33.84224,29.608938,22,"Aurukun",133,26.811594,868,3,446,179,422,24.349882,12.264151,89,816,38.88889,33.14607,178,28.921568,59,0,37,13,49,423,236,0.0,106,23,10.344828,"315011395",24.7191,126
829,2182,1104,447,437,61.686527,52.83688,189,"Cape York",1346,53.920387,5013,80,2394,846,2619,52.371918,35.79677,431,4290,58.437145,64.63134,868,57.10956,561,55,447,155,516,2108,2450,19.23077,433,286,18.306637,"315011396",43.85151,883
134,306,213,84,96,84.96732,76.36364,36,"Croydon - Etheridge",260,67.910446,738,23,336,110,402,79.18216,72.0,45,575,74.69879,81.052635,95,82.26087,77,20,91,18,124,269,473,29.850746,25,67,23.958334,"315011397",80.0,166
188,519,202,95,47,43.3526,34.92647,32,"Kowanyama - Pormpuraaw",225,40.957447,1202,9,636,272,566,34.006733,22.38806,115,1113,48.167538,43.19249,213,38.36478,92,0,77,30,92,594,427,0.0,134,42,19.148935,"315011398",27.826086,191
231,737,427,209,55,49.79647,56.334232,68,"Northern Peninsula",367,59.307358,1678,7,886,371,792,50.77289,31.799164,224,1578,58.37104,55.82192,292,50.316856,163,5,137,76,129,841,794,11.111111,239,45,12.727273,"315011399",30.357143,221
715,2346,952,306,501,49.31799,71.16279,122,"Tablelands",1157,66.993004,4568,111,1721,430,2847,70.78067,48.0,446,3691,58.96907,37.84946,930,57.13899,352,71,479,96,572,1345,2109,18.882978,200,376,22.15569,"315011400",27.35426,970
323,962,712,369,87,69.85447,75.46012,82,"Torres",672,70.588234,2167,28,1118,489,1049,69.059166,39.72603,254,1993,79.0625,79.639175,388,69.443054,309,28,228,87,253,1031,1384,32.183907,219,87,32.183907,"315011401",32.283466,320
350,1227,441,215,98,42.868786,39.3053,67,"Torres Strait Islands",526,46.57143,2642,13,1317,547,1325,36.68885,18.032787,307,2429,47.54522,49.155724,533,39.810623,262,8,163,55,184,1202,967,6.9565215,305,115,13.265306,"315011402",21.824104,387
1680,5715,4036,1980,607,85.77428,74.548195,740,"Mount Isa",4902,75.65476,12249,164,5927,2656,6322,74.65779,63.831776,1109,11121,82.61555,89.74834,2702,80.37047,2425,102,1271,683,1573,5406,8938,19.577736,1070,521,27.018122,"315021405",66.72678,1904
324,1161,648,294,150,88.97502,75.968994,130,"Mount Isa Region",1033,68.20988,2285,55,974,387,1311,74.39725,64.375,192,2032,84.199135,90.53255,507,82.72638,459,30,221,103,389,871,1681,29.126213,160,103,36.666668,"315021406",67.708336,462
379,1000,758,277,232,95.3,77.591034,132,"Northern Highlands",953,78.100266,2349,96,1117,357,1232,86.431015,75.88653,168,1877,85.03401,89.51407,391,91.1561,350,78,296,107,375,877,1711,32.5,141,240,41.37931,"315021407",78.57143,441
643,1351,1128,442,447,93.486305,81.100914,156,"Barcaldine - Blackall",1263,73.25039,3605,134,1807,545,1798,81.62084,65.46392,213,2733,81.22205,91.64882,467,87.48628,428,88,471,127,545,1382,2391,20.705883,194,425,29.977629,"315031408",73.23943,671
566,1215,1015,404,291,84.855965,79.841896,153,"Charleville",1031,74.38162,3104,74,1598,506,1506,78.68217,67.88991,233,2505,77.589455,86.91796,451,81.67664,392,42,421,148,412,1290,2046,13.636364,218,308,25.429554,"315031409",65.66524,531
262,658,504,183,179,92.09727,80.97345,85,"Far Central West",606,79.770996,1559,53,722,226,837,83.16832,72.881355,117,1264,86.13861,86.97479,238,87.81645,207,26,209,86,261,606,1110,22.413794,118,116,29.608938,"315031410",72.649574,303
414,831,656,244,233,88.688324,78.9644,80,"Far South West",737,70.04831,2092,74,1028,309,1064,76.81499,56.48855,116,1685,77.64706,87.24138,290,82.67062,253,48,290,74,330,854,1393,27.586206,131,174,31.759657,"315031411",68.965515,425
483,1025,981,367,257,93.268295,84.56221,155,"Longreach",956,80.95238,2688,81,1406,434,1282,85.37859,70.25862,198,2174,84.81013,90.084984,353,89.098434,318,60,391,163,402,1149,1937,23.346304,232,257,31.51751,"315031412",78.28283,474
1283,4774,3234,1744,380,76.53959,73.30811,547,"Mawson Lakes - Globe Derby Park",3654,70.45986,10224,76,5070,2379,5154,69.77346,54.779034,1100,9409,79.237946,84.25461,2388,73.206505,2012,53,904,533,1019,4635,6888,12.183908,973,435,20.0,"402041171",49.727272,1286
2306,4223,3532,1288,1814,82.52427,76.80382,409,"Buderim - North",3485,68.039894,13238,211,7201,1677,6037,74.154945,66.02564,735,8986,78.99497,86.31509,1498,78.088135,1293,160,1569,515,1572,4763,7017,6.5627565,780,2438,11.631753,"316011413",55.64626,1990
1567,3845,3135,1274,697,88.37451,76.0597,600,"Toowoomba - West",3398,73.38864,9475,164,4933,1675,4542,75.61505,68.47345,876,7991,85.06944,92.15173,1529,81.75447,1409,92,1150,619,1225,4146,6533,11.689961,904,787,23.529411,"317011458",68.49315,1440
2410,4648,3930,1386,1171,81.9062,76.87188,591,"Buderim - South",3807,71.53527,12384,183,6565,1803,5819,74.88567,66.95652,1036,9896,81.0102,87.8944,1553,78.183105,1365,127,1724,693,1668,5248,7737,9.643128,1035,1317,15.627668,"316011414",57.046333,2059
491,1274,1061,569,327,83.83045,81.87051,122,"Holt",1068,65.17312,3496,50,1895,695,1601,74.50843,57.142857,201,2698,74.0,90.36918,623,78.9103,563,36,320,136,333,1424,2129,7.643312,238,471,15.29052,"801011015",60.696518,450
1367,3363,2889,1268,473,84.00238,75.65633,512,"Mountain Creek",2825,71.982445,8168,78,4332,1676,3836,74.63188,72.22222,787,7234,81.11209,91.19889,1443,78.98811,1316,39,984,598,919,3871,5714,8.459869,828,461,16.490486,"316011415",65.05718,1133
920,2735,2128,899,726,76.526505,70.731705,451,"Sippy Downs",2093,70.652176,7687,60,4226,1271,3461,66.5624,52.7833,836,5932,80.103355,85.51111,1125,71.15644,962,48,650,531,620,3197,4221,4.664723,1006,1029,8.264462,"316011416",53.94737,774
1354,2816,2166,877,876,80.11364,75.408424,327,"Aroona - Currimundi",2256,66.98671,7794,88,4102,1163,3692,72.10386,63.244354,558,5820,77.16858,86.679535,1036,75.97938,898,74,907,308,943,3004,4422,6.7395263,487,1098,10.045662,"316021417",58.60215,1222
914,1851,1395,524,655,82.98217,76.608185,208,"Buddina - Minyama",1536,67.177246,5134,103,2628,684,2506,73.15155,64.07767,342,3758,74.50495,88.87304,701,77.993614,623,59,614,198,602,1907,2931,8.183079,309,721,15.725191,"316021418",60.818714,808
945,1688,1216,440,821,73.696686,72.72727,165,"Caloundra - Kings Beach",1244,56.613758,5419,85,2910,605,2509,66.52079,65.46763,268,3516,62.022194,80.62397,609,69.96587,491,59,535,182,503,1828,2460,5.452865,278,1082,10.353228,"316021419",61.567165,811
2226,5321,4344,1997,1615,82.24018,75.558075,721,"Caloundra - West",4376,66.5319,14982,126,8046,2643,6936,71.89672,65.30264,1202,11363,79.42887,90.978455,2228,76.740295,2027,100,1481,766,1502,6042,8720,4.99002,1173,2004,7.8018575,"316021420",59.98336,1891
1220,3191,2457,1127,708,77.34253,77.24469,252,"Norwood (SA)",2468,70.0,8238,186,4339,1459,3899,73.65108,51.598175,650,6527,76.10294,82.725395,1453,75.455795,1202,137,854,339,828,3336,4925,13.659023,657,1003,26.271187,"401051017",38.76923,1088
1711,2875,2151,746,1683,78.886955,73.78833,273,"Golden Beach - Pelican Waters",2268,60.25716,9580,164,5022,1011,4558,68.372536,62.9717,463,6021,69.69086,85.93073,924,73.39313,794,107,1031,267,1037,3146,4419,5.7036247,424,1876,9.744504,"316021421",58.963284,1488
895,1956,1235,492,527,72.49489,72.888885,150,"Northern Beaches",1418,62.56983,4726,74,2243,675,2483,67.708336,61.02362,294,3780,64.41394,81.67832,715,70.18519,584,28,560,155,610,1824,2653,6.6825776,254,419,14.041746,"318021486",51.02041,947
1112,2200,1692,645,769,78.181816,75.52693,244,"Moffat Beach - Battery Hill",1720,67.446045,6261,81,3292,854,2969,70.9434,57.040573,422,4585,72.387344,87.07483,735,74.41657,640,58,750,239,755,2385,3412,6.3947077,419,907,10.53316,"316021422",57.819904,1043
1199,2627,2034,827,878,81.76627,75.25023,315,"Parrearra - Warana",2148,68.473724,7382,94,3877,1099,3505,73.93675,65.34216,518,5378,77.55474,87.75913,1013,77.761246,889,90,821,296,850,2751,4182,7.992895,453,1126,10.70615,"316021423",60.81081,1096
1049,2772,1977,843,811,75.54112,70.13311,389,"Drayton - Harristown",2094,64.82364,7738,101,4155,1202,3583,67.98487,59.056316,687,5680,72.99349,80.05159,1163,71.67254,931,66,680,388,673,2908,4071,5.2927027,657,1247,12.453761,"317011447",56.622997,922
1026,2262,1807,756,531,82.44916,76.75127,316,"Wurtulla - Birtinya",1865,69.29825,5912,60,3119,985,2793,73.24686,65.13158,458,4729,77.4942,87.15499,942,77.64855,821,43,711,297,668,2467,3672,6.595092,456,652,11.299435,"316021424",68.995636,862
2563,5403,4345,1789,1816,79.60392,76.192505,643,"Maroochydore - Kuluin",4301,63.831448,15418,233,8199,2348,7219,72.79276,71.36106,960,11372,69.11628,84.56171,2293,76.02884,1939,165,1636,755,1486,5969,8646,7.399103,1058,2230,12.830397,"316031427",66.979164,2150
1684,3471,2842,1110,957,82.74273,78.55627,404,"Mooloolaba - Alexandra Headland",2872,66.68646,9231,169,4803,1413,4428,75.145424,72.55474,623,7253,75.96291,85.33887,1446,78.7812,1234,112,1123,497,1065,3782,5714,10.969638,685,1021,17.659351,"316031428",64.84751,1402
686,1122,911,295,642,88.05704,76.623375,111,"Noosa Heads",988,63.41108,3638,127,1874,385,1764,72.76358,60.220993,176,2374,73.875435,87.771736,368,79.99158,323,72,435,109,427,1252,1899,11.575562,181,622,19.78193,"316051434",63.06818,578
2087,4161,3405,1448,1025,80.99014,76.33105,385,"Coolum Beach",3370,67.03402,11054,138,5868,1897,5186,72.55487,64.88011,653,8854,74.10271,88.68591,1697,76.51909,1505,98,1399,460,1342,4693,6775,8.3404255,709,1175,13.463414,"316031425",58.958652,1811
281,837,639,321,188,80.16727,81.472084,90,"Macquarie",671,71.17438,2078,35,1053,394,1025,76.43541,63.35404,173,1673,74.44444,87.56345,394,78.30245,345,16,200,102,201,836,1310,7.373272,161,217,18.617022,"801011020",52.02312,270
1335,2137,1743,573,1179,81.235374,75.49407,206,"Noosaville",1736,63.820225,7077,161,3761,759,3316,72.20381,65.3125,359,4551,70.96774,87.95563,631,76.44474,555,109,852,209,814,2414,3479,8.092056,320,1347,13.655641,"316051435",57.381615,1147
1085,2277,1701,681,660,79.841896,69.91786,265,"Beerwah",1818,63.410137,6145,82,3208,974,2937,67.68802,60.57269,426,4790,74.329895,85.13053,881,73.46555,750,57,688,275,721,2513,3519,8.201439,454,695,12.424242,"316061439",62.206573,970
1666,3201,2416,876,934,81.724464,73.61345,367,"Marcoola - Mudjimba",2616,67.04682,8505,129,4370,1190,4135,70.78816,61.759426,590,6614,78.10611,85.29412,1122,76.08104,957,79,1117,344,1163,3413,5032,8.254964,557,957,13.811563,"316031426",62.20339,1489
2593,5503,4106,1668,1524,76.30383,69.9078,620,"Nambour",4199,65.3683,14971,199,7944,2386,7027,67.901436,55.617977,1090,11550,70.82026,82.493126,2182,71.90476,1800,149,1695,594,1580,6047,8305,7.854507,1068,1897,13.057743,"316071548",56.880733,2231
1084,1908,1617,567,494,82.7044,78.31492,189,"Sunshine Beach",1578,69.83395,5033,92,2631,724,2402,75.91549,68.32298,307,4038,75.94678,88.94231,624,79.12333,555,73,757,220,742,2130,3195,14.570858,322,501,18.623482,"316051437",61.56352,977
297,913,647,329,176,79.95619,75.98152,103,"Scullin",730,63.299664,2188,16,1099,433,1089,72.615036,68.9441,181,1804,72.98245,90.1566,447,76.330376,403,19,188,111,208,891,1377,9.134615,161,208,9.090909,"801011024",56.90608,285
1495,2489,2021,697,1210,79.469666,73.756615,286,"Tewantin",1978,64.147156,7948,146,4249,945,3699,70.61495,65.16588,480,5351,71.20799,83.92071,908,74.733696,762,90,959,275,784,2862,3999,6.488825,422,1387,12.066115,"316051438",59.583332,1101
744,2272,1821,894,257,84.419014,78.62797,344,"Bohle Plains",1918,72.98387,5171,41,2642,1137,2529,75.74875,68.45124,510,4676,83.4912,89.540565,1023,79.9615,916,26,543,358,617,2404,3739,10.92437,523,238,15.953307,"318021470",67.45098,739
634,1122,885,300,328,79.679146,77.51938,102,"Peregian Beach - Marcus Beach",894,70.82019,2943,48,1493,387,1450,74.74662,66.25767,182,2306,75.978645,83.862434,378,77.146576,317,28,449,108,427,1184,1779,9.061489,163,309,14.634147,"316051543",56.043957,562
739,1751,1459,750,541,85.66534,73.31378,163,"Peregian Springs",1500,66.71177,4942,66,2650,1023,2292,70.34715,59.615383,292,3825,79.77528,92.58373,836,77.359474,774,30,493,186,497,2074,2959,5.2083335,312,576,12.199631,"316051544",55.82192,623
827,1979,1630,662,342,86.96311,76.70915,277,"Cambooya - Wyreema",1721,76.662636,4759,80,2438,863,2321,76.489914,65.9864,414,4110,83.333336,91.19579,761,81.532845,694,43,634,291,670,2131,3351,14.006515,441,307,23.391813,"317011445",66.90821,804
1246,4050,2645,1208,829,71.703705,64.0509,550,"Darling Heights",2904,65.81059,10151,123,5272,1886,4879,65.09968,55.10204,1085,8113,72.5791,76.69095,1922,68.3964,1474,104,820,513,757,4063,5549,8.602151,931,1209,14.837153,"317011446",50.691246,1043
0,4,0,0,0,100.0,0.0,0,"Molonglo Corridor",4,0.0,4,0,0,0,4,0.0,0.0,0,4,100.0,0.0,0,100.0,0,0,0,0,4,0,4,0.0,0,0,0.0,"801011111",0.0,4
667,2171,1434,650,481,70.01382,65.92292,289,"Gatton",1520,59.670166,5706,74,3054,986,2652,59.012344,43.758045,539,4601,67.5841,73.10838,978,64.20344,715,46,398,340,442,2430,2954,7.3717947,777,624,15.384615,"317011448",53.61781,654
798,1930,1424,636,305,85.12953,76.16766,210,"Gowrie (Qld)",1643,68.79699,4497,51,2262,835,2235,72.32098,60.714287,359,3899,82.36842,93.21825,811,78.661194,756,35,549,204,626,1969,3067,11.945393,336,293,16.721312,"317011449",58.495823,760
1822,3788,2982,1149,960,86.193245,79.07777,470,"Highfields",3265,73.05159,9610,157,4862,1453,4748,76.67781,67.100975,781,7677,84.35294,92.119354,1307,81.37293,1204,90,1331,412,1434,3889,6247,9.249743,614,973,16.354166,"317011450",60.179256,1700
1568,3384,2447,861,807,82.41726,71.09827,395,"Lockyer Valley - West",2789,69.38776,8317,192,4126,1211,4191,72.20419,63.934425,663,6773,76.6879,86.707214,1151,77.30695,998,108,1088,390,1204,3389,5236,14.654003,610,737,23.791822,"317011451",59.57768,1570
944,1919,1536,573,528,87.54559,74.80418,224,"Middle Ridge",1680,72.35169,5092,117,2645,766,2447,75.0,63.01775,411,3967,86.03287,92.37805,656,81.06882,606,67,683,213,733,2048,3216,11.22278,338,597,22.15909,"317011452",54.501217,852
660,1761,1203,486,338,73.59455,70.02882,283,"North Toowoomba - Harlaxton",1296,65.30303,4298,54,2199,694,2099,67.24427,57.24138,466,3550,69.02357,78.31669,701,70.39436,549,37,431,249,410,1789,2499,9.02439,435,410,15.976332,"317011454",60.729614,594
1132,2186,1869,714,708,85.956085,75.475685,263,"Rangeville",1879,71.201416,6275,119,3381,946,2894,75.42373,65.5,438,4664,82.924225,88.77928,811,80.36021,720,87,806,262,777,2478,3748,9.634551,400,903,16.807909,"317011455",60.045662,937
1572,3583,2495,979,1091,75.2163,65.17976,494,"Wilsonton",2695,60.941475,9998,110,5324,1502,4674,64.47028,56.78392,812,7453,69.425804,81.11888,1430,69.63639,1160,106,958,452,931,3870,5190,7.2902336,796,1454,10.082493,"317011459",60.837437,1341
1182,3417,2207,785,506,86.47937,77.799805,978,"Annandale",2955,77.07276,7372,95,3449,1009,3923,76.71185,64.868805,1242,6294,83.68984,89.55366,1053,82.01462,943,66,911,445,939,2877,5162,11.538462,686,572,18.774704,"318021468",78.743965,1122
396,907,697,282,284,78.94157,81.034485,98,"Belgian Gardens - Pallarenda",716,75.0,2489,39,1298,348,1191,78.757065,56.737587,166,1792,77.830185,78.5489,317,78.85045,249,38,297,80,330,885,1413,9.200969,141,413,13.732394,"318021469",59.036144,424
1134,2546,1879,717,820,83.935585,76.276596,325,"Ayr",2137,66.666664,6894,145,3528,940,3366,73.48455,66.459625,505,5103,77.98742,86.09914,928,78.69881,799,85,756,321,868,2557,4016,8.753862,483,971,17.682926,"318011460",64.35644,1113
1076,2377,1673,567,748,89.73496,76.00536,294,"Burdekin",2133,69.609665,6023,188,2898,746,3125,75.46233,63.037975,433,4594,81.71042,89.90826,763,82.84719,686,108,749,249,965,2217,3806,15.859031,395,681,25.13369,"318011461",67.898384,1181
947,2089,1492,578,639,68.69315,67.84038,247,"Charters Towers",1435,64.30834,5743,84,3015,852,2728,65.784836,50.319828,533,4357,65.783134,76.859505,726,67.17925,558,69,609,236,546,2268,2927,9.236948,469,747,13.14554,"318011462",46.341465,830
470,1031,766,286,331,86.032974,74.479164,99,"Dalrymple",887,68.510635,2624,83,1262,384,1362,74.44121,62.285713,142,2060,74.07407,86.43617,376,80.24272,325,49,322,109,380,1029,1653,21.030043,175,233,25.07553,"318011463",69.71831,513
520,1140,773,254,534,83.24561,70.16575,132,"Ingham",949,67.69231,3386,98,1712,362,1674,70.917435,56.73077,221,2230,73.722626,84.90566,371,77.219734,315,49,352,118,404,1090,1722,7.8778133,208,622,18.35206,"318011464",59.728508,548
972,1848,1263,395,778,85.28139,78.21782,187,"Ingham Region",1576,64.609055,5037,207,2411,505,2626,73.55853,58.333332,353,3565,74.76923,87.11539,520,79.635345,453,100,628,140,729,1717,2839,14.409222,240,694,26.606684,"318011465",52.974503,975
255,769,253,104,42,30.949286,34.210526,34,"Palm Island",238,44.705883,1629,7,818,304,811,32.394367,14.414414,230,1550,40.873016,32.752613,287,31.67742,94,3,114,32,103,781,491,8.1081085,222,37,16.666666,"318011466",14.782609,252
516,1453,951,426,315,72.74604,69.268295,173,"Aitkenvale",1057,67.05426,3582,45,1814,615,1768,66.503494,48.82943,323,2883,69.590645,78.119934,617,69.64967,482,33,346,146,357,1430,2008,8.59375,299,384,14.285714,"318021467",53.56037,513
323,749,576,234,230,87.449936,84.78261,97,"Weetangera",655,70.588234,1991,47,1012,276,979,77.94317,60.0,170,1488,87.915405,88.70968,248,82.72849,220,30,228,84,291,739,1231,10.989011,140,273,20.434782,"801011026",57.058823,331
1150,2919,2037,873,654,71.634125,65.10067,385,"Condon - Rasmussen",2091,62.695652,7576,73,4003,1341,3573,63.300186,52.95736,759,6137,70.86224,79.75674,1151,67.26414,918,58,721,385,715,3218,4128,7.388535,727,785,11.16208,"318021471",50.724636,1009
593,2757,1919,764,153,70.8016,75.64356,613,"Douglas",1952,76.39123,6115,32,3205,1010,2910,63.249836,46.610764,1215,5791,82.81535,85.82915,995,66.84511,854,35,453,667,453,3034,3871,20.467836,1431,171,20.915033,"318021474",50.452675,547
449,1092,772,339,296,66.75824,66.08187,128,"Heatley",729,61.915367,3027,28,1639,513,1388,64.22629,50.833332,276,2294,65.79634,74.13395,433,65.431564,321,33,278,122,252,1202,1501,7.5514874,240,437,9.459459,"318021477",46.376812,383
2840,5306,3351,1110,1753,71.69242,64.01384,466,"Gympie Region",3804,57.74648,13876,281,6817,1734,7059,62.506996,54.637867,898,10667,64.78626,77.73488,1554,67.07603,1208,171,1640,430,1849,5361,7155,11.744506,787,1456,16.029663,"319031514",51.893097,2854
556,962,627,205,414,75.571724,63.664597,64,"Kilkivan",727,54.136692,2746,93,1370,322,1376,60.873787,39.473682,145,1992,63.904236,81.38686,274,67.971886,223,61,301,60,347,1030,1354,17.941177,152,340,22.463768,"319031515",44.13793,543
730,1288,898,315,431,65.83851,68.478264,99,"Booral - River Heads",848,60.684933,3500,47,1781,460,1719,63.284004,50.21834,205,2707,58.57988,75.18427,407,64.49944,306,25,443,115,396,1419,1746,6.9060774,229,362,10.904872,"319041516",48.292683,676
631,1489,1110,484,438,73.942245,70.96774,159,"Bundaberg East - Kalkie",1101,64.65927,4054,35,2127,682,1927,68.47625,60.714287,281,3110,70.327866,79.93311,598,71.09325,478,31,408,187,429,1621,2211,6.126482,308,506,7.9908676,"319011496",56.58363,610
778,1962,1423,610,430,73.088684,73.58263,215,"Garbutt - West End",1434,65.03856,4803,62,2411,829,2392,70.620346,64.70588,364,3977,65.85052,78.588806,822,71.838066,646,43,506,264,511,2015,2857,10.858586,408,396,14.418605,"318021475",59.065933,776
867,2340,1603,724,460,71.068375,70.841484,246,"Gulliver - Currajong - Vincent",1663,66.32065,5726,39,2926,1022,2800,67.75148,55.555557,479,4706,68.21267,79.32446,977,69.400764,775,39,575,265,603,2366,3266,6.964286,477,560,8.478261,"318021476",51.356995,884
628,1600,1300,567,270,75.5625,75.19894,211,"Hermit Park - Rosslea",1209,72.45223,3928,37,2058,754,1870,74.1163,64.51613,336,3354,68.82453,82.27474,677,74.8062,557,38,455,240,404,1754,2509,12.5,372,304,13.703704,"318021478",62.79762,587
584,1467,1059,440,272,74.77846,72.36842,174,"Hyde Park - Pimlico",1097,71.23288,3564,53,1825,608,1739,72.63374,59.398495,302,2925,70.92199,78.202995,601,73.709404,470,45,416,158,400,1458,2156,12.26158,266,367,19.485294,"318021479",57.615894,564
0,6,0,0,0,100.0,0.0,0,"West Belconnen",6,0.0,6,0,0,0,6,0.0,0.0,0,6,100.0,0.0,0,100.0,0,0,0,0,6,0,6,0.0,0,0,0.0,"801011112",0.0,6
1226,3048,2179,926,443,71.8832,66.52299,390,"Kelso",2191,65.25285,7295,74,3804,1392,3491,64.5821,54.761906,762,6422,71.42857,79.31323,1194,68.04734,947,39,800,414,780,3374,4370,9.069767,756,430,16.704288,"318021480",51.181103,1092
676,2159,1745,842,242,85.317276,82.63003,400,"Oonoonba",1842,72.63313,4836,46,2435,1019,2401,78.99502,74.70817,552,4368,80.0,91.358025,972,82.119965,888,28,491,384,508,2209,3587,12.38938,514,226,19.008265,"318021487",72.46377,635
667,1675,1221,513,271,77.850746,75.44118,193,"South Townsville - Railway Estate",1304,70.91454,3899,52,1953,680,1946,72.721855,59.638554,294,3354,71.08067,81.76796,724,75.28324,592,37,473,198,467,1679,2525,13.50365,332,274,19.188192,"318021488",65.646255,657
663,1362,986,346,372,79.88252,75.71116,111,"Townsville - South",1088,72.39819,3298,60,1564,457,1734,76.791275,70.731705,199,2646,73.60913,86.79654,462,78.38246,401,44,480,116,516,1284,2074,15.714286,164,280,16.129032,"318021489",55.778896,701
1121,3070,2293,978,501,81.88925,79.31873,408,"Townsville City - North Ward",2514,73.14897,7038,119,3467,1233,3571,76.1541,62.861492,588,6081,73.59736,86.220474,1270,79.0495,1095,82,820,413,892,3011,4807,17.982456,657,456,23.752495,"318021490",69.38776,1212
713,2228,1090,428,402,52.378815,59.610027,202,"Wulguru - Roseneath",1167,64.095375,4840,59,2210,718,2630,60.488346,47.16981,492,4030,61.85567,44.375,960,56.004963,426,30,457,175,480,1802,2257,7.352941,371,408,14.676617,"318021491",41.05691,776
600,1408,976,420,461,73.79261,70.70707,195,"Ashfield - Kepnock",1039,58.0,3904,42,2035,594,1869,65.28428,59.800663,343,2903,67.910446,82.79773,529,69.41096,438,28,348,180,364,1495,2015,5.185185,301,540,9.110629,"319011492",56.85131,536
2407,4402,3197,1214,1907,73.26215,73.044525,388,"Bargara - Burnett Heads",3225,58.86996,13063,203,6754,1662,6309,66.49335,57.374832,780,9210,66.28282,82.356995,1451,69.72855,1195,142,1417,424,1439,4808,6422,7.2970195,739,1946,10.644992,"319011493",49.74359,2171
624,1370,942,370,385,76.350365,71.01727,169,"Branyan - Kensington",1046,61.858974,3494,44,1739,521,1755,67.18973,58.365757,287,2772,70.17544,84.40546,513,71.71717,433,36,386,150,400,1402,1988,10.682492,257,337,11.428572,"319011494",58.885017,570
701,1849,1029,427,415,60.140617,57.46972,235,"Bundaberg",1112,49.500713,4620,30,2356,743,2264,55.561554,54.656864,450,3701,53.424656,66.84636,742,57.84923,496,32,347,223,351,1852,2141,6.3492064,408,504,7.2289157,"319011495",52.22222,657
926,1812,1212,412,842,70.143486,65.08689,212,"Bundaberg North - Gooburrum",1271,59.071274,5562,63,2908,633,2654,62.249615,55.670105,406,3759,65.53885,77.79605,608,66.0548,473,37,547,216,523,1947,2483,3.850156,388,961,7.4821854,"319011497",52.216747,798
1352,2426,1553,476,862,71.18714,60.10101,222,"Bundaberg Region - North",1727,57.766273,6544,126,3256,792,3288,60.901962,53.20197,439,4976,65.5416,76.29733,713,65.9164,544,80,781,216,835,2550,3280,11.331445,406,706,14.617169,"319011498",50.569477,1274
1488,2574,1597,496,1254,71.36752,65.435356,245,"Bundaberg Region - South",1837,53.696236,7518,163,3690,758,3828,60.607212,51.67095,439,5209,61.317448,78.24859,708,65.92436,554,101,799,201,875,2635,3434,9.57346,389,1055,12.998405,"319011499",55.808655,1427
654,1880,1286,537,481,88.40426,74.27386,263,"Naracoorte",1662,73.7003,4608,114,2247,723,2361,77.42324,65.49296,371,3541,81.73077,88.348274,781,83.25332,690,81,482,186,595,1661,2948,13.822526,284,586,23.700624,"407021154",70.88949,728
851,1734,1308,528,826,74.567474,69.74901,202,"Millbank - Avoca",1293,60.28202,5625,60,3065,757,2560,65.99394,59.625668,356,3716,70.95376,78.7172,686,69.99462,540,44,513,223,491,1982,2601,4.0627885,374,1083,7.2639227,"319011500",56.741573,692
700,1499,1020,396,554,68.045364,64.28571,174,"Svensson Heights - Norville",1020,59.285713,4401,40,2348,616,2053,62.73063,58.387096,318,3125,62.698414,74.59165,551,65.28,411,28,415,181,395,1626,2040,3.8781164,310,722,7.2202168,"319011501",54.71698,630
2628,6361,4832,2082,1812,77.5507,73.96092,602,"Rostrevor - Magill",4933,70.54794,17383,260,9210,2815,8173,71.62763,53.798927,1353,13107,77.04849,85.1682,2616,74.502174,2228,195,1854,701,1843,6746,9765,7.913961,1303,2464,14.348785,"401041016",44.493717,2392
255,507,335,106,162,85.996056,68.83117,53,"Loxton Region",436,67.05882,1281,50,612,154,669,69.07217,50.0,83,992,73.30961,88.81119,143,77.72177,127,20,171,38,206,485,771,15.748032,76,127,30.864197,"407031163",63.855423,281
1299,2833,1876,757,946,68.33745,63.241436,324,"Walkervale - Avenell Heights",1936,56.966896,8069,80,4290,1197,3779,60.73163,53.794266,627,5922,63.59018,76.19512,1025,64.37015,781,60,740,319,751,3089,3812,4.9958367,593,1201,8.456659,"319011502",51.67464,1181
838,1774,1320,469,699,85.34386,73.62637,181,"Gayndah - Mundubbera",1514,67.06444,4864,169,2391,637,2473,74.2825,61.589405,296,3551,73.27888,86.3124,621,79.8085,536,103,562,186,628,1777,2834,16.775244,302,614,24.177397,"319021503",61.148647,857
793,1399,723,227,622,59.47105,54.30622,103,"Gin Gin",832,45.397224,3881,76,1860,418,2021,51.422474,42.05128,227,2805,50.563206,66.756035,373,55.43672,249,54,360,82,404,1406,1555,11.894273,195,454,12.21865,"319021504",45.37445,799
751,1490,996,387,576,72.95302,68.37456,172,"Tinana",1087,57.123837,4170,47,2104,566,2066,63.238094,58.52713,298,3065,66.388885,82.62712,472,67.960846,390,29,429,151,478,1575,2083,5.4820414,258,529,8.159722,"319051526",57.71812,720
2057,3551,2469,919,1777,62.827374,66.25811,308,"Torquay - Scarness - Kawungan",2231,53.330093,11523,123,6195,1387,5328,59.62328,53.371593,695,7692,56.238808,72.6503,1181,61.102444,858,81,1097,372,942,4141,4700,3.9435248,697,2054,6.921778,"319041520",44.316547,1675
2157,5023,4044,1714,1115,83.05793,75.94151,636,"Mount Barker",4172,70.60732,13058,215,6920,2257,6138,73.527275,61.60221,1100,10523,80.53333,88.427734,2048,78.07659,1811,138,1523,669,1510,5500,8216,9.718309,1086,1420,19.28251,"401021007",57.81818,1875
978,1968,1554,537,411,85.772354,76.71429,198,"Mount Barker Region",1688,75.46012,4783,130,2404,700,2379,76.81661,61.449276,360,3991,80.497925,90.68323,644,81.23277,584,67,738,212,776,2023,3242,17.585302,345,381,31.63017,"401021008",55.0,964
1183,2815,2045,834,791,77.72646,67.530365,398,"Kingaroy",2188,64.41251,7586,101,3980,1235,3606,67.35837,61.97411,651,5851,73.521126,82.43858,1099,72.34661,906,66,762,383,783,3036,4233,6.9915257,618,944,12.768647,"319021505",61.13671,1065
1185,2419,1426,498,1002,66.887146,57.17566,217,"Kingaroy Region - North",1618,54.683544,6925,177,3504,871,3421,56.632248,35.714287,496,4937,61.53846,66.932274,753,61.656876,504,115,648,165,720,2518,3044,11.663286,462,986,17.66467,"319021506",43.75,1170
581,1118,843,286,387,86.4043,72.95918,100,"Kingaroy Region - South",966,67.81411,2931,127,1426,392,1505,75.13369,59.060402,184,2240,74.82517,85.911606,362,80.75893,311,75,394,88,428,1122,1809,24.671053,149,304,32.816536,"319021507",54.347828,572
452,956,677,225,411,86.61088,67.36527,82,"Monto - Eidsvold",828,67.92036,2688,125,1321,334,1367,72.71751,52.41379,143,1887,72.265625,83.3887,301,79.756226,251,69,307,76,370,931,1505,17.692308,145,390,30.413626,"319021508",57.34266,512
1432,2477,1286,414,1281,57.00444,53.350517,179,"Nanango",1412,42.178772,7400,125,3642,776,3758,50.07788,51.944443,411,5045,51.97828,56.370655,777,53.47869,438,81,604,187,670,2568,2698,7.541899,360,1074,9.758001,"319021509",43.55231,1289
744,1472,1192,444,543,87.839676,74.62185,104,"Augusta",1293,72.71506,4032,143,2017,595,2015,79.25532,64.242424,169,2976,75.96796,86.10108,554,83.50134,477,101,541,106,569,1504,2485,19.688108,165,513,26.335175,"501011001",61.53846,749
3425,6850,5420,2087,2353,82.78832,70.9864,787,"Busselton",5671,67.41606,19537,359,10334,2940,9203,70.61889,61.67939,1333,14525,77.13508,87.58728,2578,76.358,2258,216,2309,808,2267,7675,11091,8.123355,1310,2659,15.257118,"501011002",59.03976,2939
1277,2972,2296,1033,762,88.930016,76.86012,237,"Busselton Region",2643,72.59201,7421,167,3687,1344,3734,77.38457,63.872833,379,5939,81.41593,91.75424,1237,83.16215,1135,115,927,221,1104,2967,4939,15.972222,346,720,21.91601,"501011003",62.53298,1356
1062,2627,2137,1051,402,87.05748,75.50288,242,"Margaret River",2287,74.38795,6258,104,3229,1392,3029,76.59498,68.75,376,5417,80.27613,91.10752,1237,81.66882,1127,65,790,231,814,2790,4424,14.806378,336,439,25.870647,"501011004",64.3617,1014
2190,5084,3720,1597,984,81.49095,69.19411,565,"Australind - Leschenault",4143,66.84931,12479,144,6411,2308,6068,69.05513,62.767155,994,10471,79.17687,88.72621,2049,75.09312,1818,101,1464,558,1616,5387,7863,9.863281,889,1024,14.634147,"501021005",56.841045,2041
753,1469,1163,424,403,85.15997,71.260506,132,"Capel",1251,73.17397,3816,98,1944,595,1872,73.4681,59.574467,246,3052,79.407616,89.10506,514,79.09567,458,48,551,140,563,1583,2414,13.296399,235,361,24.317617,"501021007",53.658535,709
0,0,0,0,0,0.0,0.0,0,"North Burnett",0,0.0,0,0,0,0,0,0.0,0.0,0,0,0.0,0.0,0,0.0,0,0,0,0,0,0,0,0.0,0,0,0.0,"319021510",0.0,0
915,1394,738,241,1075,54.806313,57.932693,75,"Cooloola",764,41.202187,4923,75,2454,416,2469,49.39759,47.239265,189,2888,44.3038,68.15476,336,52.00831,229,43,377,77,385,1494,1502,4.4791665,163,960,6.976744,"319031511",39.68254,869
1785,3713,2414,964,1122,67.11554,61.794872,397,"Gympie - North",2492,54.061626,10412,109,5577,1560,4835,58.168674,49.93789,787,7863,61.56915,74.5429,1422,62.39349,1060,83,965,402,926,4150,4906,5.816398,805,1427,9.714795,"319031512",50.444725,1504
749,1344,964,340,481,72.99107,74.72527,117,"Craignish - Dundowran Beach",981,58.744995,3701,39,1876,455,1825,67.7442,67.12329,220,2767,68.382355,81.08108,444,70.29273,360,37,440,147,465,1423,1945,8.16777,219,453,8.1081085,"319041517",53.18182,680
1605,2970,2037,862,1954,64.98316,64.714714,304,"Pialba - Eli Waters",1930,48.909657,10752,90,5828,1332,4924,57.203033,50.80128,602,6531,54.34956,76.68162,1115,60.74108,855,73,785,317,681,3561,3967,3.2201147,624,2267,4.6059365,"319041518",50.49834,1253
753,1350,845,318,704,63.925926,61.271675,128,"Point Vernon",863,50.863213,4326,52,2272,519,2054,55.886242,49.583332,262,2862,54.27683,75.05618,445,59.678547,334,25,383,119,349,1512,1708,3.2894738,240,760,7.3863635,"319041519",48.85496,643
1001,2438,1492,670,528,69.319115,64.60945,236,"Pooraka - Cavan",1690,60.93906,6038,47,3072,1037,2966,60.798695,41.826923,530,4892,66.92913,79.68597,1019,65.04497,812,38,610,174,595,2454,3182,6.148867,416,618,8.901515,"402041172",44.5283,889
1794,3125,2228,842,1487,69.184,67.90323,303,"Urangan - Wondunna",2162,55.518394,9666,116,5054,1240,4612,61.78591,57.16783,549,6731,61.279896,77.259476,1029,65.22062,795,63,996,327,948,3606,4390,4.3508286,572,1448,7.8009415,"319041521",55.191257,1547
1439,2247,1347,476,1332,57.76591,58.333332,148,"Burrum - Fraser",1298,46.212646,7278,84,3699,816,3579,52.535103,46.278316,339,4811,49.920383,67.33129,652,54.978176,439,63,665,143,627,2564,2645,5.5506606,309,1135,6.3063064,"319051522",43.657818,1256
813,2015,1621,731,347,82.77916,81.403114,213,"Nailsworth - Broadview",1668,77.244774,4847,65,2485,898,2362,79.460785,65.04559,371,4055,82.251656,86.501686,889,81.10974,769,48,628,214,621,2040,3289,10.786517,329,445,18.731989,"401061020",57.4124,755
1527,3141,2594,972,718,82.68067,81.13522,414,"Golden Grove",2597,72.56058,8116,93,4257,1198,3859,76.76827,66.666664,708,6520,83.43994,89.278755,1026,79.61656,916,78,1108,436,1174,3379,5191,8.883827,654,878,12.952646,"402051049",58.474575,1407
391,840,481,179,322,61.309525,60.472973,77,"Granville",515,51.91816,2385,21,1223,296,1162,56.4554,48.484848,163,1692,58.39599,66.18705,278,58.86525,184,19,203,80,233,852,996,5.121294,165,371,6.521739,"319051523",47.239265,399
2337,5196,2747,1006,1813,54.253273,58.899296,429,"Maryborough (Qld)",2819,52.50321,14031,140,7022,1708,7009,55.57354,45.657017,1056,10139,52.80694,56.08004,1949,54.896935,1093,104,1227,410,1157,4943,5566,5.002405,898,2079,7.7220078,"319051524",40.625,2191
1408,2253,1214,368,1113,59.43187,59.8374,127,"Maryborough Region - South",1339,45.88068,6488,130,3122,615,3366,53.05944,43.396225,300,4541,50.92115,65.60403,596,56.221096,391,85,646,115,691,2288,2553,10.191847,265,834,11.680143,"319051525",42.333332,1357
1864,4874,3481,1488,820,78.82642,77.05852,514,"Prospect",3842,73.87339,11422,157,5728,1931,5694,74.52366,60.27397,1026,9545,79.46832,84.90385,2080,76.720795,1766,88,1377,528,1405,4671,7323,8.325449,876,1057,19.146341,"401061021",50.097466,1768
993,6127,2806,1535,614,51.60764,65.99312,427,"Adelaide",3162,62.63847,12945,173,6204,2326,6741,50.31379,22.984941,2069,11704,60.758514,64.2444,2766,50.991116,1777,130,622,519,785,5577,5968,20.733652,2258,627,28.175896,"401011001",20.637989,1292
706,2240,1612,632,579,75.04464,74.970345,241,"North Adelaide",1681,70.679886,5855,188,3036,843,2819,69.904594,46.63144,684,4546,80.98802,80.067566,888,72.43731,711,128,499,353,541,2306,3293,17.534246,757,730,32.469776,"401011002",35.233917,668
1114,2170,1678,481,544,86.72811,79.37294,262,"Adelaide Hills",1882,76.75045,5375,144,2661,606,2714,79.001884,60.89109,460,4294,84.45415,90.08849,565,82.90638,509,96,855,246,967,2124,3560,17.877094,404,537,26.470589,"401021003",56.95652,1145
2659,5131,4230,1496,1423,87.11752,81.61484,502,"Aldgate - Stirling",4470,76.19406,13358,388,6804,1833,6554,79.13938,55.099648,957,10476,83.539894,89.38442,1592,83.04697,1423,238,2026,470,2157,5345,8700,16.312542,853,1459,27.266338,"401021004",52.45559,2582
671,1253,1040,337,455,88.34796,81.99513,142,"Hahndorf - Echunga",1107,73.62146,3506,100,1798,411,1708,78.84761,64.55696,249,2572,83.98058,89.63731,386,83.47589,346,56,494,153,519,1319,2147,11.691023,237,479,21.978022,"401021005",57.028114,618
1329,2700,2105,711,723,86.333336,77.1987,320,"Lobethal - Woodside",2331,74.416855,7001,170,3578,921,3423,76.62905,57.545273,561,5447,82.2169,91.52542,885,81.43932,810,119,989,286,1031,2747,4436,14.320096,497,831,23.51314,"401021006",57.040997,1254
2589,5380,4328,1524,1635,82.41636,74.34146,521,"Burnside - Wattle Park",4434,72.46041,14834,395,7819,2050,7015,73.617966,53.951614,1232,11259,83.78378,86.03913,1891,77.82219,1627,259,1876,669,1891,5879,8762,13.350515,1240,1940,24.159021,"401031011",42.28896,2257
1390,2932,2294,832,754,83.390175,79.92315,348,"Athelstone",2445,74.7482,7508,140,3822,1041,3686,75.93512,57.966103,636,5953,82.87462,88.36032,988,79.60692,873,81,1039,342,1084,3021,4739,10.11236,590,801,18.567638,"401041014",54.71698,1308
1304,2651,2160,772,891,84.043755,77.4323,237,"Glenside - Beaumont",2228,72.92945,7588,244,4046,997,3542,72.653885,44.642857,593,5624,84.44976,85.572136,804,78.02276,688,137,951,300,1059,2973,4388,12.767941,672,1073,27.38496,"401031012",39.966274,1254
2127,4257,3450,1298,1448,82.7813,74.5977,404,"Toorak Gardens",3524,70.94499,12517,370,6812,1740,5705,72.494225,47.197308,926,9016,81.66759,83.61842,1520,77.35137,1271,222,1509,421,1479,4759,6974,10.813444,892,2053,25.552486,"401031013",43.62851,1811
2366,5862,4118,1797,1753,76.81679,73.46689,596,"Paradise - Newton",4503,67.49789,15890,206,8275,2446,7615,70.32104,55.84291,1207,11718,74.849464,83.53365,2496,73.57057,2085,141,1597,583,1616,5856,8621,5.828855,1044,2419,11.751284,"401041015",49.378624,2159
0,0,0,0,0,0.0,0.0,0,"Happy Valley Reservoir",0,0.0,0,0,0,0,0,0.0,0.0,0,0,0.0,0.0,0,0.0,0,0,0,0,0,0,0,0.0,0,0,0.0,"403041081",0.0,0
1434,3582,2798,1297,1042,76.71692,76.836494,345,"Payneham - Felixstow",2748,69.3166,10137,118,5513,1688,4624,72.28107,54.47263,719,7453,74.296875,84.27037,1583,74.41299,1334,99,994,408,951,3871,5546,6.0292325,749,1642,11.324376,"401051018",47.98331,1280
2281,5324,4466,1920,1211,82.419235,79.07743,522,"Goodwood - Millswood",4388,73.78343,14001,266,7466,2428,6535,75.91365,57.41056,1002,11207,80.17366,86.17163,2249,79.004196,1938,189,1683,674,1662,5883,8854,11.939356,1174,1583,21.965319,"401071023",52.09581,2073
10,383,0,0,8,0.0,0.0,0,"Hume",0,0.0,427,0,36,19,391,0.0,0.0,68,419,0.0,0.0,249,0.0,0,0,0,0,0,36,0,0.0,7,0,0.0,"801031031",0.0,66
0,3,7,7,0,100.0,100.0,0,"Kowen",3,0.0,10,0,7,7,3,100.0,0.0,0,10,0.0,100.0,3,100.0,3,0,0,0,0,7,10,0.0,0,0,0.0,"801031032",0.0,0
1708,4152,3179,1310,933,79.33526,77.51479,407,"St Peters - Marden",3294,74.94145,10451,204,5366,1690,5085,76.107254,59.691914,884,8329,79.63659,84.44976,1672,77.716415,1412,124,1280,465,1271,4177,6473,10.428932,779,1189,21.864952,"401051019",46.040726,1596
1000,2214,1628,588,738,80.442635,76.66232,225,"Walkerville",1781,71.8,6097,182,3145,767,2952,72.13115,43.265305,490,4471,76.9968,82.92994,785,76.246925,651,110,718,212,723,2257,3409,12.387387,490,888,24.661247,"401061022",45.918365,939
2228,5669,3968,1745,741,76.980064,68.592766,689,"Craigmore - Blakeview",4364,65.35009,13356,83,6946,2544,6410,65.532616,55.416992,1275,11724,78.82752,84.33476,2330,71.067894,1965,56,1456,711,1627,6055,8332,6.285073,1283,891,11.201079,"402021028",54.039215,2064
1580,5144,2556,1313,645,59.642303,51.611637,520,"Davoren Park",3068,46.07595,11841,49,6052,2544,5789,47.500465,37.86794,1234,10525,55.234425,69.65576,2353,53.43468,1639,39,728,476,860,5381,5624,5.8122206,1257,671,7.596899,"402021029",42.139385,1557
1267,3118,2258,1022,803,78.73637,75.92868,331,"Reynella",2455,65.90371,8063,90,4142,1346,3921,71.18537,58.318424,576,6290,72.45614,86.16263,1402,74.92846,1208,75,835,326,826,3172,4713,7.731959,559,970,11.20797,"403041086",57.46528,1140
2006,5309,3093,1443,979,67.771706,62.413494,441,"Parafield Gardens",3598,54.43669,12858,98,6570,2312,6288,56.992813,44.634808,1079,10736,66.44433,77.3345,2281,62.323025,1764,63,1092,495,1295,5427,6691,5.5118113,1109,1143,10.010215,"402041043",40.871178,1949
1534,3880,2129,863,869,63.505154,57.648632,406,"Elizabeth East",2464,55.149937,9728,74,4979,1497,4749,55.027138,42.36277,875,7749,62.775185,69.25631,1506,59.272163,1043,65,846,355,941,3869,4593,5.855856,838,1110,8.515535,"402021031",46.4,1499
1094,3692,2569,1290,350,78.54821,68.690094,495,"Munno Para West - Angle Vale",2900,65.4479,8337,46,4295,1878,4042,65.63618,56.369427,866,7606,77.746475,86.93924,1761,71.90376,1531,32,716,531,828,3914,5469,8.398951,942,381,13.142858,"402021032",57.159355,1065
448,839,599,159,208,86.293205,81.95876,107,"One Tree Hill",724,73.66071,1994,52,947,194,1047,76.598465,64.28571,187,1621,85.681816,88.679245,212,81.61629,188,20,330,90,377,782,1323,12.121212,140,165,25.0,"402021033",57.21925,440
1090,3016,991,392,675,47.977455,34.057343,229,"Elizabeth",1447,37.06422,7492,43,3801,1151,3691,34.79635,27.841845,673,5864,47.450302,52.782463,1186,41.575718,626,26,404,169,549,2848,2438,2.7282267,607,953,6.3703704,"402021030",34.026745,1157
1342,3603,1511,639,717,52.317513,43.737167,313,"Smithfield - Elizabeth North",1885,41.80328,8799,49,4479,1461,4320,42.58737,36.91275,817,7151,49.84917,59.041096,1460,47.48986,862,36,561,275,661,3548,3396,3.8668098,745,931,6.8340306,"402021034",38.310894,1326
499,1224,744,288,437,72.87582,69.902916,113,"Virginia - Waterloo Corner",892,60.32064,3249,50,1588,412,1661,65.55066,54.464287,215,2359,65.76576,80.17621,454,69.35142,364,33,301,122,365,1135,1636,7.284768,224,453,11.441648,"402021035",52.55814,555
2230,7985,4035,2156,1288,64.395744,64.31981,653,"Enfield - Blair Athol",5142,55.246635,17861,123,8588,3352,9273,58.38518,40.55681,1618,14896,58.018093,75.0953,3935,61.607143,2955,108,1232,539,1411,6911,9177,6.4400716,1329,1677,9.549689,"402031036",40.358467,2432
2624,8001,5109,2740,1588,68.46644,70.74619,657,"Northgate - Oakden - Gilles Plains",5478,61.35671,19262,171,9673,3873,9589,65.846115,49.6038,1563,15760,67.66947,75.107735,3945,67.1764,2963,133,1610,626,1687,7759,10587,6.948798,1262,1914,10.768262,"402031037",42.03455,2493
1742,4351,2875,1298,1359,72.99471,70.27612,399,"Ingle Farm",3176,63.088406,11718,117,6008,1847,5710,66.35126,50.537636,867,8684,71.29987,80.414505,1930,69.67987,1552,102,1099,376,1108,4333,6051,6.0895524,744,1675,8.609271,"402041040",46.02076,1554
2158,6470,4516,2470,1193,75.62597,72.56169,524,"Windsor Gardens",4893,63.253014,16013,140,8350,3404,7663,67.21238,48.401035,1146,13189,70.591156,84.80821,3311,71.33975,2808,121,1365,560,1421,6719,9409,7.4187617,1157,1631,11.735122,"402031038",45.72426,2013
1794,4348,3397,1571,1179,76.080956,78.08151,452,"Morphettville",3308,66.10925,11886,138,6359,2012,5527,73.00666,62.101536,859,9001,70.64739,83.98314,1898,74.49172,1594,114,1186,526,1124,4653,6705,6.6822977,847,1706,11.704835,"403021062",52.619324,1591
0,0,0,0,0,0.0,0.0,0,"Dry Creek - North",0,0.0,0,0,0,0,0,0.0,0.0,0,0,0.0,0.0,0,0.0,0,0,0,0,0,0,0,0.0,0,0,0.0,"402041039",0.0,0
8,29,25,20,3,110.34483,100.0,4,"Canberra Airport",32,62.5,64,3,32,20,32,89.28571,0.0,4,57,100.0,100.0,12,100.0,12,0,5,0,13,28,57,0.0,0,4,100.0,"801031114",100.0,13
1841,4585,3137,1307,1015,76.72846,68.42932,496,"Para Hills",3518,66.92015,11286,133,5686,1910,5600,67.66609,57.514126,939,9221,75.409836,82.84496,1877,72.17222,1555,89,1232,509,1334,4636,6655,8.476191,885,1050,13.103448,"402041041",52.82215,1769
0,81,3,3,0,12.345679,17.647058,6,"Parafield",10,0.0,101,0,20,17,81,15.0,0.0,37,101,0.0,9.090909,44,12.871287,4,0,0,0,0,20,13,0.0,3,0,0.0,"402041042",16.216217,0
23,50,33,10,15,116.0,100.0,8,"Majura",58,69.565216,116,8,51,10,65,82.5,42.857143,8,90,100.0,100.0,16,101.11111,16,4,16,3,26,40,91,36.363636,7,11,53.333332,"801031115",100.0,26
1827,5400,2990,1510,757,67.12963,60.135403,599,"Salisbury North",3625,49.753696,12501,65,6344,2511,6157,54.751877,46.304543,1208,10861,62.211983,76.58795,2456,60.905994,1881,51,909,520,1080,5461,6615,5.7757645,1123,883,8.586526,"402041048",49.586094,1736
2108,5570,3380,1490,620,71.05924,63.458263,583,"Paralowie",3958,60.294117,12450,81,6260,2348,6190,60.035522,48.55196,1245,11200,73.09003,78.94273,2270,65.51786,1792,49,1271,570,1502,5630,7338,7.7777777,1174,630,13.064516,"402041044",46.82731,2055
1981,5414,2642,1151,1282,62.81862,52.270664,478,"Salisbury",3401,48.712772,13511,105,6815,2202,6696,50.38139,42.035816,1127,10658,60.430214,70.367134,2288,56.699192,1610,80,965,446,1208,5244,6043,5.092298,1061,1571,8.190328,"402041046",42.413486,1999
2314,5383,3616,1422,1335,75.3669,67.64986,597,"Salisbury East",4057,64.7796,13722,157,7004,2102,6718,66.53174,57.605495,1127,10818,73.96367,81.31816,2109,70.928085,1715,108,1499,587,1588,5435,7673,6.883365,1019,1569,11.7603,"402041047",52.972492,2147
1337,2908,2350,953,395,83.18432,80.89983,380,"Greenwith",2419,72.026924,6877,74,3574,1178,3303,75.97801,67.12803,643,6001,84.640526,89.24111,1041,79.470085,929,46,963,388,1036,3093,4769,9.56341,578,481,18.734177,"402051050",59.097977,1224
1443,3167,2480,970,955,83.70698,80.96828,334,"Highbury - Dernancourt",2651,72.557175,8325,155,4203,1198,4122,76.68522,58.684654,605,6401,80.78078,88.29269,1230,80.15935,1086,115,1047,348,1076,3234,5131,11.867905,593,969,16.230366,"402051051",55.20661,1332
2158,5804,3675,1677,1007,70.89938,71.483376,613,"Woodville - Cheltenham",4115,60.56534,13776,118,6965,2346,6811,64.67793,51.95246,1274,11486,69.579285,79.38319,2367,67.82169,1879,79,1307,612,1505,5682,7790,6.1574435,1178,1283,11.717974,"404011097",48.11617,2163
1820,4707,3260,1537,1595,75.52581,73.05133,455,"Hope Valley - Modbury",3555,62.912086,13316,142,7014,2104,6302,68.4874,55.382774,893,9467,73.63744,80.66792,2126,71.9869,1715,115,1145,463,1243,4760,6815,5.102041,836,2254,8.902822,"402051052",50.951847,1688
2860,5924,4749,1808,1337,81.44835,76.87075,668,"Modbury Heights",4825,71.64336,15071,194,7810,2352,7261,74.459076,65.523155,1168,12302,78.97477,88.136345,2259,77.824745,1991,128,2049,764,1972,6378,9574,8.938547,1166,1432,14.510098,"402051053",57.19178,2497
2148,5045,3860,1595,1205,82.87413,78.33988,575,"Redwood Park",4181,73.370575,12526,179,6276,2036,6250,76.40538,64.63134,992,10097,79.70869,89.23376,2062,79.63752,1840,128,1576,561,1587,5052,8041,10.457517,868,1224,14.854772,"402051054",57.96371,1991
1605,3607,2840,1207,1223,82.45079,79.72259,378,"St Agnes - Ridgehaven",2974,70.529594,10096,161,5266,1514,4830,75.19195,60.94225,692,7384,79.88981,87.14969,1463,78.73781,1275,100,1132,401,1160,3777,5814,6.7159166,658,1489,13.16435,"402051055",54.62428,1452
1245,2717,2269,947,849,84.210526,81.70837,293,"Marino - Seaview Downs",2288,74.69879,7338,135,3772,1159,3566,79.75395,64.39909,517,5562,80.6563,88.86756,1042,81.93096,926,108,930,284,934,2845,4557,11.650485,441,927,15.90106,"403021060",56.673115,1158
2015,3824,3229,1204,1404,82.322174,81.07744,406,"Brighton (SA)",3148,70.12407,11264,191,6036,1485,5228,77.62019,66.21212,691,7984,77.11306,87.414185,1311,79.872246,1146,175,1413,437,1405,4160,6377,9.328359,660,1876,13.603989,"403011056",58.75543,1822
1713,4524,3143,1481,1200,68.3687,69.99055,440,"Mitchell Park",3093,60.53707,12338,133,6614,2116,5724,63.64925,48.602345,968,9462,63.379356,76.461914,2035,65.90573,1556,86,1037,539,964,4938,6236,5.1312647,1109,1676,11.083333,"403021061",45.454544,1521
2711,5844,4844,1907,1823,83.590004,81.39138,628,"Glenelg (SA)",4885,72.51936,16234,348,8567,2343,7667,78.585335,64.5045,1098,12008,77.69414,87.66877,2222,81.02099,1948,255,1966,716,1961,6164,9729,10.611735,1110,2403,19.089413,"403011057",57.1949,2524
1571,4478,3183,1521,742,73.49263,74.12281,479,"Edwardstown",3291,66.199875,10858,93,5638,2052,5220,70.749054,60.27397,871,8977,67.01031,81.70316,2055,72.11764,1679,94,1040,528,1040,4499,6474,8.252853,876,1139,12.533692,"403021058",54.99426,1552
1984,4021,3146,1162,864,83.31261,77.62191,474,"Hallett Cove",3350,71.47177,9969,150,5084,1497,4885,74.320816,62.898937,789,8254,81.15155,88.569374,1391,78.70123,1232,93,1418,473,1494,4233,6496,10.92832,752,851,17.36111,"403021059",60.076046,1841
1384,3315,2743,1240,423,84.43439,81.47175,349,"Sheidow Park - Trott Park",2799,74.92774,7719,68,3981,1522,3738,77.68337,67.2,593,6846,82.10361,92.26519,1448,80.95238,1336,46,1037,420,1046,3531,5542,10.222222,625,450,16.07565,"403021063",58.853287,1274
1859,4399,3374,1472,1170,72.266426,72.90738,477,"Warradale",3179,65.08876,12061,120,6492,2019,5569,69.7684,61.273487,922,9235,67.84287,79.139244,1975,70.95831,1563,105,1210,587,1019,4836,6553,6.3405795,958,1656,10.256411,"403021064",51.73536,1502
688,1363,1090,340,451,84.73955,83.333336,161,"Belair",1155,77.906975,3693,97,1879,408,1814,80.92056,60.159363,326,2710,87.034035,85.71429,420,82.84133,360,63,536,151,537,1347,2245,11.842105,251,532,21.507761,"403031065",49.3865,617
840,2164,1583,582,705,72.73567,65.76271,237,"Bellevue Heights",1574,72.02381,6128,118,3259,885,2869,65.063705,42.937855,565,4597,79.305916,73.32521,821,68.675224,602,92,605,304,617,2433,3157,11.138015,708,826,16.737589,"403031066",41.946903,778
1680,3515,2939,1128,1028,85.17781,82.51646,399,"Blackwood",2994,78.21429,9370,182,4827,1367,4543,79.261055,56.278366,729,7223,84.42838,89.24051,1264,82.14039,1128,125,1314,372,1285,3708,5933,11.170688,661,1119,17.70428,"403031067",54.73251,1522
2006,4707,3938,1715,953,81.72934,81.010864,479,"Colonel Light Gardens",3847,74.82552,12105,141,6445,2117,5660,77.44346,61.434513,898,9792,80.42328,88.952576,1919,79.50368,1707,131,1501,591,1520,5085,7785,9.632353,962,1360,14.795383,"403031068",53.340755,1890
2292,4576,3901,1401,1320,83.3042,80.378654,490,"Mitcham (SA)",3812,74.65096,12529,296,6633,1743,5896,76.98836,57.751938,1010,9643,83.63726,86.46714,1537,79.98548,1329,193,1711,596,1697,5067,7713,12.324393,1032,1566,22.424242,"403031069",48.51485,2029
881,2337,1653,732,771,76.294395,73.93939,246,"Panorama",1783,69.466515,6426,91,3318,990,3108,72.08897,54.028435,464,4630,74.52153,79.36355,1037,74.21166,823,81,612,228,623,2293,3436,7.902439,422,1025,11.802854,"403031070",53.017242,836
643,1794,1476,739,162,85.95318,82.66219,227,"Amaroo",1542,78.22706,4036,25,2080,894,1956,77.930305,61.62465,365,3688,86.464966,93.25843,801,81.83297,747,14,503,220,543,1894,3018,7.5268817,357,186,15.432098,"801041034",62.19178,628
1811,3751,2965,1074,737,80.91176,77.88252,446,"Aberfoyle Park",3035,73.49531,9350,121,4862,1379,4488,74.91157,63.020832,818,7709,81.08276,87.85822,1326,77.83111,1165,76,1331,484,1303,3958,6000,8.40708,768,904,16.41791,"403041071",54.523228,1607
1170,2773,1780,800,790,70.78976,65.25285,258,"Morphett Vale - West",1963,57.77778,7357,97,3794,1226,3563,62.107468,49.148937,518,5639,61.77908,79.22078,1232,66.377014,976,73,676,231,632,2866,3743,7.8663793,470,928,12.278481,"403041085",49.80695,1023
341,757,572,206,267,80.84544,72.79152,88,"Fulham",612,72.14076,2156,28,1132,283,1024,75.16426,67.15328,155,1518,78.4153,88.55932,236,77.99737,209,28,246,92,287,761,1184,7.5471697,137,371,10.486892,"404031105",56.774193,366
1114,2699,1538,679,679,62.76399,60.195034,256,"Christie Downs",1694,51.52603,7003,62,3625,1128,3378,55.343647,45.251396,549,5478,55.734406,71.10727,1156,58.999634,822,42,574,243,554,2779,3232,4.964539,537,846,9.131075,"403041073",46.630238,994
859,1472,1005,277,665,75.815216,67.07022,108,"Peterborough - Mount Remarkable",1116,64.4936,4257,142,2120,413,2137,67.95132,43.47826,234,2951,66.627495,77.26098,387,71.87394,299,84,554,90,567,1479,2121,13.104525,207,641,21.353384,"405031121",46.153847,851
1761,4002,2491,950,1215,65.66717,64.84641,415,"Port Pirie",2628,59.34128,10803,102,5586,1465,5217,61.780754,52.8536,874,8034,62.977753,73.23637,1375,63.716705,1007,70,1045,426,1104,4032,5119,4.5045047,806,1554,8.3950615,"405031122",47.482838,1753
1818,4346,3075,1376,968,74.57432,68.15255,432,"Aldinga",3241,62.706272,11085,108,5771,2019,5314,65.7754,55.608593,858,9021,71.43678,83.409615,1748,70.01441,1458,93,1140,466,1243,4675,6316,8.485401,838,1096,11.157024,"403041072",50.34965,1740
722,2104,1144,406,493,67.20532,74.632355,155,"Grant",1414,68.42105,4509,131,1912,544,2597,75.962814,65.0,295,3610,64.371254,59.8513,807,70.85873,483,88,494,156,645,1506,2558,21.674877,240,406,26.572008,"407021150",52.542374,1002
628,1326,1110,432,295,86.65158,81.818184,155,"Coromandel Valley",1149,78.98089,3278,59,1657,528,1621,79.97118,61.63793,276,2714,84.91228,93.958336,480,83.23508,451,39,496,143,484,1388,2259,14.498141,232,269,20.0,"403041076",56.15942,570
1822,4055,3268,1391,1129,84.291,79.9885,452,"Happy Valley",3418,72.941826,10777,147,5593,1739,5184,76.177155,61.59122,735,8345,79.65497,90.298965,1639,80.119835,1480,99,1329,449,1339,4290,6686,7.5978513,729,1303,13.020372,"403041080",61.496597,1681
1216,2948,1931,760,845,70.454544,66.84257,302,"Christies Beach",2077,64.802635,7673,70,3880,1137,3793,65.99453,53.9267,567,5874,66.5345,77.32143,1120,68.23289,866,74,788,309,839,2926,4008,7.7568135,573,954,8.284023,"403041074",53.262787,1261
460,813,681,190,247,89.05289,83.70044,85,"Clarendon",724,74.78261,2136,73,1076,227,1060,79.92958,60.60606,152,1665,84.34004,88.31776,214,84.384384,189,47,344,100,377,852,1405,20.982143,165,224,29.554655,"403041075",55.92105,447
985,2268,1324,569,499,61.948853,57.41675,223,"Hackham West - Huntfield Heights",1405,51.573605,5749,37,2982,991,2767,55.23571,49.643707,458,4665,56.568047,69.11917,965,58.499466,667,38,508,209,478,2397,2729,6.4957266,421,585,7.4148297,"403041079",48.689957,845
1513,3272,2610,961,860,84.47433,78.89983,405,"Flagstaff Hill",2764,75.61137,8368,169,4236,1218,4132,76.92308,60.574017,690,6665,83.02018,87.074234,1145,80.63016,997,104,1144,401,1193,3393,5374,12.336892,662,843,19.651163,"403041077",58.695652,1437
894,1922,1383,522,509,76.638916,71.801926,208,"Hackham - Onkaparinga Hills",1473,65.88367,5021,66,2590,727,2431,69.11544,57.63158,380,3923,74.545456,81.450485,717,72.80143,584,53,589,219,615,2001,2856,8.998302,380,589,12.966601,"403041078",54.736843,825
4,0,0,0,7,0.0,0.0,0,"Lonsdale",4,0.0,11,4,4,0,7,0.0,0.0,0,4,0.0,0.0,0,100.0,0,0,0,0,0,4,4,0.0,0,0,57.142857,"403041082",0.0,0
867,1651,1327,456,629,86.250755,80.85107,183,"McLaren Vale",1424,71.395615,4711,115,2431,564,2280,77.421234,64.664314,333,3365,81.28141,91.76245,522,81.75334,479,69,619,183,647,1714,2751,9.623431,283,717,18.28299,"403041083",54.954956,796
1714,4124,2858,1192,1052,74.41804,69.78923,464,"Morphett Vale - East",3069,64.06068,10709,87,5533,1708,5176,67.51713,57.706535,853,8357,72.57653,81.03347,1703,70.92258,1380,100,1098,468,1138,4233,5927,7.6923075,811,1300,8.269962,"403041084",54.396248,1568
537,1032,821,261,292,84.20543,78.143715,114,"Willunga",869,75.60522,2671,71,1347,334,1324,77.96771,62.087914,215,2085,78.75243,92.10526,304,81.05515,280,41,406,113,404,1053,1690,13.945579,182,294,24.31507,"403041088",53.023254,513
1579,3472,2875,1128,755,82.22926,81.32661,448,"Woodcroft",2855,74.60418,8908,93,4681,1387,4227,76.76903,65.46855,787,7217,81.84377,91.06013,1264,79.395874,1151,59,1178,510,1163,3745,5730,6.3034186,779,936,12.317881,"403041089",56.925034,1421
941,2522,1820,850,441,75.77319,76.30161,227,"Beverley",1911,70.88204,6022,63,3059,1114,2963,73.65439,62.98077,449,4993,72.083336,83.4681,1113,74.72462,929,41,667,262,692,2471,3731,6.9727893,416,588,14.285714,"404011090",50.556793,960
1804,4331,3246,1406,1215,78.11129,74.47034,419,"Flinders Park",3383,68.45898,11691,137,6145,1888,5546,71.497795,58.490566,817,8871,74.87745,85.28162,1882,74.72664,1605,109,1235,496,1222,4540,6629,6.7912774,848,1605,11.275721,"404011091",51.28519,1632
2085,4618,3496,1323,1221,81.39887,79.26902,516,"Henley Beach",3759,72.3741,11907,190,6068,1669,5839,75.96697,63.443398,940,9220,79.18307,87.72782,1646,78.68764,1444,126,1509,538,1609,4602,7255,8.594816,848,1466,15.561015,"404011092",54.893616,2032
404,780,663,248,253,84.35897,85.51724,89,"Hughes",658,73.0198,2240,33,1207,290,1033,78.554504,63.333332,152,1624,82.35294,88.888885,288,81.34236,256,25,295,95,280,844,1321,6.8870525,150,363,13.043478,"801091103",58.55263,340
2160,5983,4171,2012,1053,72.589005,77.59352,571,"Hindmarsh - Brompton",4343,65.50926,14267,111,7231,2593,7036,70.68294,57.229965,1168,11884,67.61769,82.559,2712,71.64255,2239,87,1415,657,1422,5901,8514,6.541353,1148,1330,10.54131,"404011093",48.886986,2103
731,1829,1293,620,387,73.209404,76.260765,166,"Royal Park - Hendon - Albert Park",1339,62.106705,4641,34,2425,813,2216,69.62843,61.661343,316,3686,63.953487,84.72727,825,71.40532,699,26,454,193,440,1857,2632,4.5774646,313,568,8.78553,"404011094",52.531647,688
286,698,543,211,160,84.67049,82.101166,85,"Torrens",591,79.72028,1720,35,862,257,858,80.68351,68.46154,159,1371,83.561646,91.90283,247,82.71335,227,15,228,89,244,673,1134,7.9365077,130,189,21.875,"801091110",53.459118,292
2167,4702,3474,1483,1469,77.62654,75.54763,509,"Seaton - Grange",3650,63.728657,13077,168,6906,1963,6171,69.647156,58.15851,904,9690,71.59091,85.230934,1862,73.51909,1587,111,1381,499,1386,4988,7124,5.7872787,858,1918,11.436351,"404011095",56.30531,1936
2088,3911,3076,1091,1733,84.58195,75.658806,417,"West Lakes",3308,66.81035,11819,328,6175,1442,5644,74.12048,62.096775,753,8061,78.71982,84.31373,1377,79.19613,1161,205,1395,385,1402,4150,6384,10.123457,620,2025,18.926716,"404011096",55.378487,1781
0,0,0,0,0,0.0,0.0,0,"Dry Creek - South",0,0.0,0,0,0,0,0,0.0,0.0,0,0,0.0,0.0,0,0.0,0,0,0,0,0,0,0,0.0,0,0,0.0,"404021098",0.0,0
2002,5930,3117,1623,1095,61.28162,61.75799,471,"The Parks",3634,47.402596,14336,86,7311,2628,7025,53.209286,39.495113,1301,11788,54.6472,75.91298,2574,57.270103,1954,60,949,485,1123,5858,6751,4.1293874,1228,1453,7.8538814,"404021102",36.20292,2055
0,0,0,0,0,0.0,0.0,0,"Torrens Island",0,0.0,0,0,0,0,0,0.0,0.0,0,0,0.0,0.0,0,0.0,0,0,0,0,0,0,0,0.0,0,0,0.0,"404021103",0.0,0
2314,4601,3756,1499,1002,77.83091,80.63475,411,"Largs Bay - Semaphore",3581,72.428696,11759,138,6156,1859,5603,76.31044,61.415222,723,9523,73.39449,83.6746,1807,77.04505,1512,121,1676,460,1520,4922,7337,9.8055105,749,1234,13.772455,"404021099",56.846474,2071
0,0,0,0,0,0.0,0.0,0,"Adelaide Airport",0,0.0,0,0,0,0,0,0.0,0.0,0,0,0.0,0.0,0,0.0,0,0,0,0,0,0,0,0.0,0,0,0.0,"404031104",0.0,0
2124,4358,3165,1225,1179,75.42451,72.78669,463,"North Haven",3287,65.301315,11543,139,6006,1683,5537,68.95425,56.449554,825,8948,71.73587,81.5515,1534,72.1055,1251,111,1387,442,1434,4590,6452,7.838983,783,1416,11.789652,"404021100",56.121212,1999
1495,3550,2216,988,746,67.521126,71.28427,272,"Port Adelaide",2397,58.729095,8629,88,4333,1386,4296,64.02774,50.172413,611,7011,61.796246,77.05598,1447,65.79661,1115,59,878,291,922,3461,4613,6.766055,580,872,11.796247,"404021101",44.517185,1492
1542,4053,2934,1308,952,79.02788,74.19172,421,"Lockleys",3203,71.78989,10303,149,5298,1763,5005,72.212654,57.651714,794,8116,75.81744,84.86879,1791,75.616066,1520,82,1107,437,1113,4063,6137,6.639676,758,1235,15.65126,"404031106",53.02267,1468
2504,7745,5602,2717,1707,77.26275,75.26316,822,"Plympton",5984,70.207664,19501,245,10049,3610,9452,71.85736,56.718193,1622,15541,74.25373,84.23605,3711,74.551186,3126,173,1758,954,1791,7796,11586,7.678651,1682,2253,14.352666,"404031107",50.678177,2412
1849,5570,3972,2008,959,72.67504,76.20493,522,"Richmond (SA)",4048,68.03677,13456,116,6927,2635,6529,70.17668,53.316326,1124,11230,69.251625,81.9754,2602,71.41585,2133,79,1258,627,1277,5660,8020,6.2352014,1176,1267,12.095933,"404031108",46.44128,1844
651,1277,1009,372,429,87.94048,81.57895,137,"Tanunda",1123,70.81413,3571,74,1865,456,1706,77.854935,70.89947,236,2573,83.02207,93.58407,452,82.86047,423,42,461,134,489,1296,2132,7.381371,189,569,17.249416,"405011115",58.050846,589
522,1105,928,371,398,90.950226,81.71806,126,"Clare",1005,73.37165,3104,85,1601,454,1503,81.048035,69.23077,189,2250,83.16222,90.67599,429,85.91111,389,57,383,117,405,1145,1933,12.5,169,456,21.356785,"405021116",66.666664,487
766,1373,1014,300,510,84.632195,68.64989,110,"Gilbert Valley",1162,69.32115,3761,132,1878,437,1883,72.792534,47.36842,197,2766,73.53308,88.26667,375,78.669556,331,93,531,90,589,1393,2176,19.175259,190,485,25.882353,"405021117",55.837563,801
612,1223,754,246,412,78.57727,68.14404,103,"Goyder",961,62.7451,3202,93,1567,361,1635,66.43172,43.209877,196,2358,70.04608,82.180855,376,72.731125,309,54,384,70,456,1135,1715,12.5,162,432,22.572815,"405021118",52.55102,651
1260,2677,1665,585,1008,78.109825,65.36313,269,"Wakefield - Barunga West",2091,62.460316,7226,192,3541,895,3685,65.60284,47.780678,483,5215,69.393936,81.69337,874,72.02301,714,110,787,183,916,2538,3756,10.967098,383,1003,19.047619,"405021119",55.69358,1320
632,1304,919,322,509,84.04908,77.21822,148,"Jamestown",1096,68.51266,3524,133,1711,417,1813,75.14309,54.022987,239,2527,70.66869,85.99509,407,79.73882,350,70,433,94,465,1223,2015,14.344262,174,488,26.129665,"405031120",61.924686,658
594,1058,621,199,516,65.21739,59.402985,79,"Wallaroo",690,52.020203,3187,48,1613,335,1574,57.55329,57.333332,154,2137,55.923344,73.333336,330,61.347683,242,27,309,86,321,1079,1311,5.05618,150,534,9.302325,"405041126",51.298702,574
1005,1873,1193,366,1040,77.78964,69.84733,144,"Yorke Peninsula - North",1457,61.19403,5747,157,2834,524,2913,68.05476,50.44643,260,3626,66.06975,82.427536,552,73.08329,455,99,615,113,701,1753,2650,9.158187,224,1081,15.096154,"405041127",55.384617,1061
0,19,3,3,0,100.0,100.0,0,"Western",19,0.0,22,0,3,3,19,100.0,0.0,0,22,100.0,100.0,10,100.0,10,0,0,0,9,3,22,0.0,0,0,0.0,"406011135",0.0,9
2654,6601,3857,1632,1536,67.005,64.53143,582,"Whyalla",4423,58.741524,16320,127,8183,2529,8137,60.539948,48.232323,1288,12972,64.162865,76.542206,2464,63.82979,1886,93,1559,573,1828,6371,8280,5.13245,1188,1812,8.2682295,"406011136",45.186337,2849
0,0,0,0,0,0.0,0.0,0,"Whyalla - North",0,0.0,0,0,0,0,0,0.0,0.0,0,0,0.0,0.0,0,0.0,0,0,0,0,0,0,0,0.0,0,0,0.0,"406011137",0.0,0
206,653,298,133,53,34.150078,41.304348,41,"APY Lands",223,55.339806,1484,16,778,322,706,40.934067,17.5,192,1381,44.375,31.561462,301,37.726284,95,16,114,35,71,728,521,32.0,200,50,30.188679,"406021138",21.354166,160
188,479,308,128,213,69.102295,72.72727,24,"Coober Pedy",331,70.74468,1229,35,537,176,692,72.30047,40.322582,53,905,55.27426,74.60317,189,70.607735,141,22,133,25,131,426,639,19.81982,62,111,16.431925,"406021139",45.28302,237
335,598,426,125,239,75.08361,71.83908,39,"Quorn - Lake Gilles",449,65.07462,1656,47,819,174,837,71.95946,60.240963,84,1190,67.51412,77.5,160,73.52941,124,33,218,50,239,592,875,14.537445,83,227,19.665272,"406021140",46.42857,354
294,1028,457,172,167,88.91051,74.78261,73,"Outback",914,72.789116,1883,57,688,230,1195,75.164474,55.95238,109,1636,81.052635,89.86487,444,83.801956,399,24,214,47,385,608,1371,30.0,84,80,34.131737,"406021141",66.97248,475
1638,4145,2579,1002,930,62.726177,67.79432,407,"Port Augusta",2600,66.23932,9970,113,4895,1478,5075,67.09157,55.21978,790,7989,64.21181,59.871494,1712,64.82664,1025,90,1085,402,1055,3844,5179,8.563273,728,1051,12.150537,"406021142",51.518986,1643
289,1488,789,455,24,94.62366,75.20661,165,"Roxby Downs",1408,78.20069,2574,19,1062,605,1512,74.92877,67.92453,218,2541,94.178795,97.71863,789,86.46202,771,0,226,108,453,1053,2197,0.0,159,9,79.166664,"406021143",75.68807,481
1543,2437,1746,530,1941,70.94788,67.68838,178,"Goolwa - Port Elliot",1729,57.809464,9165,145,4787,783,4378,65.02793,57.381615,336,5122,61.464497,76.76903,749,67.84459,575,118,892,206,831,2685,3475,5.6137013,359,2102,7.470376,"407011144",52.97619,1352
681,1305,1074,361,485,84.36781,81.306305,111,"Kangaroo Island",1101,74.59618,3566,138,1776,444,1790,83.19132,65.66265,171,2596,69.655174,84.84107,409,83.782745,347,96,508,109,505,1291,2175,19.793814,166,485,28.453608,"407011145",64.91228,725
954,1846,1471,536,688,82.286026,71.276596,193,"Strathalbyn",1519,69.7065,5394,117,2860,752,2534,71.51191,54.985756,361,3903,78.41561,85.667755,614,76.607735,526,77,665,193,683,2057,2990,9.589041,351,803,17.005814,"407011146",53.462605,871
1109,2176,1668,543,647,83.91544,75.62674,205,"Strathalbyn Region",1826,71.6862,5604,169,2781,718,2823,75.54348,57.217846,376,4384,76.9163,87.06767,665,79.698906,579,112,795,218,873,2208,3494,19.546247,381,573,26.120556,"407011147",54.52128,1135
278,741,588,284,101,88.394066,78.888885,89,"Wulagi",655,75.179855,1700,25,858,360,842,78.29561,61.061947,145,1492,86.37993,94.63722,317,83.31099,300,26,209,69,241,751,1243,24.299065,113,107,24.752476,"701021030",61.37931,279
1902,3029,2240,743,2461,74.083855,68.41621,295,"Victor Harbor",2244,56.887486,11829,214,6339,1086,5490,64.64646,57.651993,543,6494,64.24283,78.21682,987,69.048355,772,140,1082,275,963,3465,4484,4.8712597,477,2874,8.695652,"407011148",54.32781,1499
921,1483,1084,314,761,78.55698,67.81857,117,"Yankalilla",1165,60.152008,4567,142,2323,463,2244,68.65105,65.64103,202,3062,66.89815,78.657074,417,73.44872,328,88,554,128,578,1579,2249,11.827957,195,744,18.659658,"407011149",57.92079,864
354,700,557,173,197,106.14286,79.357796,54,"Naracoorte Region",743,80.79096,1687,115,790,218,897,85.82435,54.545456,90,1349,93.9314,94.37229,231,96.36768,218,56,286,42,356,649,1300,39.716312,77,141,58.375633,"407021155",60.0,379
430,920,670,244,284,90.108696,71.9764,98,"Penola",829,67.209305,2378,104,1174,339,1204,74.610245,58.139534,162,1818,80.141846,85.970146,335,82.45325,288,62,289,75,339,898,1499,22.463768,129,276,36.619717,"407021156",60.493828,423
767,2072,1471,557,510,93.822395,80.959305,277,"Tatiara",1944,80.70404,4862,163,2280,688,2582,84.057144,64.745766,393,3822,87.325455,92.37968,748,89.35113,691,104,619,191,813,1750,3415,19.62264,295,530,31.960785,"407021157",70.48346,931
522,925,696,203,315,85.4054,66.12378,89,"Wattle Range",790,67.62452,2474,92,1234,307,1240,72.65136,54.263565,139,1883,74.29719,82.986115,288,78.916626,239,70,353,70,370,958,1486,25.362318,129,276,29.206348,"407021158",64.02878,498
1910,4213,3295,1294,1071,81.34346,75.4519,496,"Mount Gambier - East",3427,70.8377,10981,178,5697,1715,5284,73.56553,62.763466,820,8692,78.27298,84.355446,1598,77.33548,1348,112,1353,536,1405,4479,6722,9.195402,854,1218,16.619982,"407021173",60.487804,1795
1813,4037,2954,1124,1117,80.87689,71.184296,502,"Mount Gambier - West",3265,67.73304,10739,159,5585,1579,5154,70.233,60.68796,842,8243,78.0,85.48495,1495,75.44583,1278,108,1228,494,1326,4206,6219,7.8317623,814,1379,14.234557,"407021174",59.619953,1700
938,1883,1334,436,638,78.7573,71.35843,179,"Barmera",1483,69.6162,5046,125,2525,611,2521,71.72043,55.305466,335,3743,72.68908,81.71141,596,75.26048,487,73,653,172,692,1860,2817,10.977444,311,665,19.592476,"407031159",53.432835,952
477,1108,752,317,355,67.68953,67.01903,114,"Berri",750,61.63522,3064,37,1601,473,1463,64.88352,57.416267,227,2267,61.758244,74.64789,426,66.25496,318,21,294,120,281,1159,1502,4.751131,209,442,10.422535,"407031160",50.220264,455
401,852,623,204,332,93.42723,74.181816,79,"Karoonda - Lameroo",796,71.07232,2303,100,1119,275,1184,78.66161,57.75862,117,1644,79.85948,89.61039,308,86.313866,276,67,285,67,341,792,1419,20.489296,116,327,30.120481,"407031161",67.52137,427
2039,6496,4576,2304,1040,79.07944,66.13088,817,"Butler - Merriwa - Ridgewood",5137,66.748405,15955,128,8419,3484,7536,64.56893,53.452686,1512,13583,80.1579,86.54345,3084,71.50851,2669,75,1361,836,1523,7087,9713,5.6306305,1564,1332,12.307693,"505031099",54.034393,1900
695,1495,1127,431,535,81.67224,78.07971,166,"Loxton",1221,69.06475,4172,85,2142,552,2030,74.242424,57.93358,290,3013,75.574715,87.229866,509,77.92898,444,59,480,157,526,1518,2348,9.455129,271,624,15.887851,"407031162",57.24138,696
2092,5295,3248,1246,1487,68.25307,65.303986,609,"Murray Bridge",3614,61.23327,13660,158,6878,1908,6782,63.648834,55.213055,1110,10398,66.33417,69.58716,2180,65.99346,1517,112,1281,609,1330,5103,6862,6.3098593,1103,1775,10.625421,"407031165",54.864864,2005
517,1149,797,276,341,83.63795,78.85714,119,"Murray Bridge Region",961,72.53385,2792,103,1302,350,1490,76.04962,49.72376,225,2197,77.10197,84.38356,365,80.0182,308,56,375,90,431,1048,1758,22.047245,181,254,30.205278,"407031166",52.88889,559
538,1235,792,322,447,70.688255,64.788734,139,"Renmark",873,57.992565,3598,40,1916,497,1682,60.643185,46.494465,252,2541,67.21649,73.895584,498,65.52538,368,32,312,126,326,1306,1665,5.2459016,271,610,8.948545,"407031167",55.15873,485
686,1526,1077,379,389,86.95937,73.59223,174,"Renmark Region",1327,74.052475,3703,96,1788,515,1915,75.52595,60.88889,273,2952,81.070496,89.52772,487,81.43632,436,53,508,137,621,1426,2404,14.640884,225,362,24.678663,"407031168",63.736263,766
737,1527,1006,319,572,83.95547,63.168316,163,"The Coorong",1282,66.485756,4114,141,2015,505,2099,68.52861,50.44248,266,2995,73.73212,83.53658,492,76.39399,411,83,490,114,567,1468,2288,15.173675,226,547,24.65035,"407031169",61.278194,769
916,2084,1204,377,714,70.39347,66.9627,180,"Waikerie",1467,64.73799,5247,119,2449,563,2798,68.918144,54.104477,329,3831,66.63386,66.44114,739,69.7207,491,89,593,145,677,1747,2671,12.678062,268,702,16.666666,"407031170",54.711246,1016
1115,3201,2357,1168,478,82.31802,74.25302,304,"Craigie - Beldon",2635,70.9417,7457,81,3778,1573,3679,73.19876,62.406013,513,6421,77.71587,87.709496,1611,77.744896,1413,66,791,332,837,3220,4992,11.827957,532,558,16.945606,"505011070",59.25926,1077
802,2252,1237,506,441,63.987568,63.09227,247,"College Grove - Carey Park",1441,61.346634,5206,51,2513,802,2693,62.919632,54.972374,453,4218,63.267815,63.756344,985,63.489807,628,40,492,199,515,1966,2678,7.3126144,362,547,11.564626,"501021008",54.525387,814
1152,2580,1523,575,676,68.37209,60.91102,272,"Collie",1764,55.90278,6513,69,3257,944,3256,59.538704,52.38095,530,5138,65.40084,74.91329,865,63.974308,648,62,644,242,775,2558,3287,8.869814,462,699,10.207101,"501021009",51.320755,1185
498,955,705,211,228,86.80628,70.09967,98,"Dardanup",829,69.47791,2338,76,1155,301,1183,73.05699,64.45783,166,1920,79.87679,88.07947,302,79.895836,266,41,346,107,389,965,1534,21.578947,166,190,33.333332,"501021010",59.036144,487
947,2679,1990,921,263,82.9414,69.04048,363,"Dalyellup",2222,72.0169,6157,49,3215,1334,2942,68.762955,57.585644,614,5573,84.69273,89.91453,1170,75.57868,1052,34,682,353,758,2894,4212,10.5919,613,321,18.631178,"501021251",59.12052,895
4,5,0,0,0,100.0,0.0,0,"Davenport",5,0.0,9,0,4,0,5,0.0,0.0,0,9,100.0,0.0,0,55.555557,0,0,0,0,5,4,5,0.0,0,0,0.0,"501021011",0.0,5
1355,3379,2477,1063,799,84.07813,69.56806,433,"Eaton - Pelican Point",2841,68.413284,8612,96,4434,1528,4178,69.79431,65.76576,677,6928,81.39351,89.22863,1439,76.76097,1284,49,927,438,1028,3549,5318,5.536723,666,885,12.015018,"501021012",63.95864,1263
1177,2624,1681,602,715,81.82165,65.15151,255,"Harvey",2147,64.14613,6580,162,3241,924,3339,66.1811,55.125286,507,5164,78.90691,85.20084,946,74.128586,806,82,755,242,924,2540,3828,11.697575,439,701,22.657343,"501021014",50.295856,1171
909,1975,1486,616,535,80.658226,71.13164,225,"East Bunbury - Glen Iris",1593,66.44665,5267,86,2757,866,2510,69.084145,58.776596,364,4126,76.32912,82.70402,821,74.62434,679,45,604,221,603,2151,3079,7.4257426,376,606,16.074766,"501021015",61.813187,790
550,1156,728,259,353,78.460205,64.75,108,"Waroona",907,59.454544,3009,67,1500,400,1509,63.85965,56.31579,203,2296,72.852234,83.01887,371,71.2108,308,35,327,107,424,1140,1635,9.722222,190,360,18.98017,"501021016",53.20197,582
522,933,676,202,190,81.2433,73.454544,108,"Gelorup - Stratham",758,70.68965,2291,34,1168,275,1123,67.26368,45.673077,211,1938,83.57588,88.796684,241,73.993805,214,10,369,95,402,1005,1434,6.134969,208,163,17.894737,"501021252",51.184834,481
1652,3411,2717,1016,1042,84.43272,72.4679,331,"South Bunbury - Bunbury",2880,72.63923,9457,204,5004,1402,4453,75.24232,67.145424,558,7022,77.97501,87.01201,1332,79.706635,1159,127,1200,374,1186,3611,5597,9.117014,557,1393,19.577736,"501021253",59.318996,1521
641,1490,925,388,325,68.05369,59.692307,133,"Withers - Usher",1014,59.126366,3754,36,1939,650,1815,58.433353,45.547947,302,3073,67.52137,74.62687,603,63.09795,450,25,379,133,395,1583,1939,7.022472,292,356,11.076923,"501021254",44.039734,585
964,1653,1268,408,704,86.1464,69.863014,130,"Bridgetown - Boyup Brook",1424,64.93776,4808,185,2451,584,2357,71.63842,52.25225,234,3423,74.319916,85.2,500,78.64446,426,118,626,116,683,1770,2692,17.32746,222,681,26.27841,"501031017",55.555557,919
908,1608,1171,368,549,84.26617,64.903,128,"Donnybrook - Balingup",1355,65.96916,4391,141,2234,567,2157,68.882355,51.555557,253,3308,76.670715,85.52631,532,76.36034,455,88,599,116,631,1700,2526,16.4794,225,534,25.68306,"501031018",50.592884,823
754,1580,1188,405,419,85.06329,70.8042,190,"Manjimup",1344,73.4748,4073,125,2074,572,1999,72.88344,54.605263,335,3210,79.20228,87.10866,543,78.8785,473,63,554,166,556,1630,2532,14.189189,304,444,29.832935,"501031019",56.71642,702
790,1409,1001,296,585,84.45706,73.08642,113,"Pemberton",1190,68.6076,3811,164,1817,405,1994,74.3685,49.006622,209,2755,72.88344,82.85714,385,79.52813,319,89,542,74,594,1346,2191,18.895966,151,471,28.034187,"501031020",54.066986,815
905,1902,1276,522,720,77.39222,64.28571,157,"Dawesville - Bouvard",1472,59.337017,5281,75,2659,812,2622,62.795277,54.920635,311,3934,73.64939,83.62573,684,69.85257,572,44,537,173,668,2032,2748,7.017544,315,627,10.416667,"502011021",50.482315,907
1242,2388,1672,592,954,75.67001,65.05495,261,"Falcon - Wannanup",1807,60.869564,6841,102,3499,910,3342,64.13502,56.043957,456,4995,70.755554,80.2974,807,69.64965,648,69,756,255,796,2607,3479,7.735426,455,892,10.691824,"502011022",57.236843,1125
1183,2504,1568,568,1040,70.646965,54.985477,303,"Greenfields",1769,59.171597,7595,64,4051,1033,3544,57.456944,48.927876,576,5233,70.12321,75.366875,954,63.768394,719,49,700,251,683,2729,3337,3.7065053,513,1322,6.1538463,"502011023",52.604168,974
2443,4777,3503,1273,1988,80.44798,66.5795,620,"Halls Head - Erskine",3843,63.03725,14288,241,7523,1912,6765,65.66073,57.7551,1062,10112,76.79505,84.80149,1612,72.64636,1367,124,1540,566,1615,5335,7346,5.667276,980,2188,12.122736,"502011024",58.380413,2103
2687,6271,4292,1554,824,76.57471,67.594604,793,"Ballajura",4802,68.36621,14409,155,7314,2299,7095,66.90569,55.983204,1530,12686,80.46475,82.243416,2202,71.685326,1811,101,1837,800,2043,6415,9094,11.234705,1429,899,18.81068,"504031056",51.830067,2539
1192,2509,1486,532,941,67.35751,57.88901,230,"Mandurah",1690,54.78188,7165,95,3715,919,3450,57.5969,50.53305,461,5089,62.707184,71.10187,962,62.40912,684,64,653,237,681,2580,3176,5.6387663,469,1135,10.095643,"502011025",49.89154,1086
824,1552,1027,331,716,75.64433,63.653847,155,"Mandurah - East",1174,56.796116,4525,71,2257,520,2268,62.507607,60.20067,282,3195,70.53455,80.91451,503,68.888885,407,48,468,180,541,1643,2201,7.8175898,299,614,9.916202,"502011026",54.96454,767
1980,5051,3619,1646,1105,81.13245,66.88338,625,"Mandurah - North",4098,65.65656,12917,125,6761,2461,6156,65.76413,56.21469,1082,10554,79.636765,88.33643,2152,73.119194,1901,76,1300,597,1447,5503,7717,6.0413356,1062,1258,11.312217,"502011027",57.7634,1817
1390,2485,1667,518,1263,71.79074,56.612022,223,"Mandurah - South",1784,56.043167,8079,141,4331,915,3748,58.904594,52.57143,481,5315,66.46235,76.68214,862,64.92944,661,94,779,276,759,2830,3451,6.2624917,525,1501,11.163896,"502011028",46.361748,1142
1111,2519,1663,651,864,78.443825,62.237095,252,"Pinjarra",1976,61.11611,6949,130,3566,1046,3383,62.168224,48.648647,482,5194,75.13761,81.83738,947,70.06161,775,81,679,252,819,2675,3639,9.090909,518,891,15.046296,"502011029",52.282158,1090
943,1836,1336,334,586,86.22005,70.464134,251,"City Beach",1583,67.86851,5057,147,2635,474,2422,70.13123,54.918034,481,3741,86.28692,90.17199,407,78.02727,367,94,640,268,818,1905,2919,12.876713,488,730,25.085323,"503011030",52.182953,948
0,0,0,0,0,0.0,0.0,0,"Malaga",0,0.0,0,0,0,0,0,0.0,0.0,0,0,0.0,0.0,0,0.0,0,0,0,0,0,0,0,0.0,0,0,0.0,"504031063",0.0,0
993,2178,1698,670,744,84.802574,77.99767,258,"Claremont (WA)",1847,65.15609,6310,229,3388,859,2922,72.688354,48.76033,548,4514,80.5658,86.29131,817,78.533455,705,145,647,236,655,2336,3545,13.78327,484,1052,30.77957,"503011031",47.08029,813
1015,2147,1701,679,588,89.333954,79.41521,199,"Cottesloe",1918,69.16256,5651,193,2916,855,2735,75.36553,56.33075,401,4404,85.051544,90.33505,776,82.17529,701,102,702,218,825,2257,3619,15.477997,387,659,32.823128,"503011032",49.625935,970
1151,2339,1836,639,442,85.8914,76.52695,294,"Floreat",2009,74.45699,5755,105,2974,835,2781,74.72527,59.447983,540,4796,88.44086,91.215225,683,80.170975,623,60,857,280,987,2457,3845,11.605416,471,517,23.755655,"503011033",54.444443,1116
1354,2853,2338,952,758,84.963196,76.5889,287,"Mosman Park - Peppermint Grove",2424,65.06647,7857,242,4246,1243,3611,68.72428,42.608696,596,6255,80.890686,87.671234,1022,76.131096,896,162,881,343,999,3402,4762,19.194313,805,844,31.92612,"503011034",48.15436,1235
2105,5948,3687,1210,1303,71.63753,63.85224,779,"Nedlands - Dalkeith - Crawley",4261,67.553444,14733,439,7482,1895,7251,61.89357,40.981094,2072,11905,85.161964,72.01835,1962,66.76186,1413,253,1422,802,1630,5957,7948,16.590164,1957,1525,33.691483,"503011035",37.596523,1914
1255,2522,1875,607,651,83.34655,73.754555,284,"Swanbourne - Mount Claremont",2102,70.99602,6563,216,3390,823,3173,73.014015,53.061226,713,5090,86.72481,90.99099,777,78.1336,707,117,891,260,895,2568,3977,14.233577,490,822,33.17972,"503011036",39.831696,1032
3,6,3,0,6,150.0,0.0,0,"Kings Park (WA)",9,100.0,21,3,9,0,12,100.0,0.0,0,9,100.0,0.0,0,133.33333,0,0,3,0,6,3,12,0.0,0,6,50.0,"503021037",0.0,6
1210,3423,2949,1591,398,86.50307,83.124344,260,"Mount Hawthorn - Leederville",2961,74.95868,8078,83,4257,1914,3821,79.659645,64.01384,458,7125,84.69218,90.754395,1763,82.947365,1600,81,907,370,1018,3702,5910,14.594595,578,555,20.85427,"503021038",56.76856,1202
2049,5318,4406,2087,900,84.41143,82.42496,491,"Mount Lawley - Inglewood",4489,72.18155,12981,214,6763,2532,6218,77.20344,61.278862,878,11025,81.1214,88.42147,2496,80.680275,2207,150,1479,690,1577,5707,8895,14.204545,1126,1056,23.777779,"503021039",55.92255,1944
1038,2884,2332,1205,496,83.84189,83.44875,244,"North Perth",2418,73.41041,6958,95,3578,1444,3380,79.69925,67.567566,416,5810,76.90858,89.76546,1407,81.75559,1263,65,762,300,816,2926,4750,9.969325,444,652,19.153225,"503021040",58.653847,1061
2224,11834,7809,5063,1232,81.36725,76.84019,945,"Perth City",9629,65.28777,24876,316,11810,6589,13066,73.28266,59.034184,1649,22490,72.147285,85.85058,7442,77.53668,6389,206,1452,1088,1979,10656,17438,17.850954,1843,1154,25.649351,"503021041",57.30746,2743
2002,4851,3967,1836,1232,86.53886,76.627716,442,"Subiaco - Shenton Park",4198,71.67832,12711,329,6628,2396,6083,75.80737,57.964073,785,10084,79.82456,87.912575,2242,80.96986,1971,212,1435,484,1456,5233,8165,15.197133,835,1395,26.704546,"503021042",56.305733,1824
0,0,0,0,0,0.0,0.0,0,"Melaleuca - Lexia",0,0.0,0,0,0,0,0,0.0,0.0,0,0,0.0,0.0,0,0.0,0,0,0,0,0,0,0,0.0,0,0,0.0,"504031064",0.0,0
1794,5625,4453,2399,894,84.85333,77.337204,508,"Wembley - West Leederville - Glendalough",4773,71.79487,13567,185,7048,3102,6519,77.16167,66.85714,870,11396,81.13542,88.3812,3064,80.95823,2708,181,1288,585,1372,5771,9226,14.173845,875,1277,20.693512,"503021043",58.390804,1691
1869,4668,3515,1645,955,79.884315,75.11416,413,"Bassendean - Eden Hill - Ashfield",3729,69.60941,11666,182,6043,2190,5623,73.13774,59.57162,810,9474,77.12054,84.80155,2066,76.4619,1752,124,1301,445,1382,4806,7244,10.024252,747,1237,19.057592,"504011044",50.987656,1792
1406,3457,2601,1058,543,83.30923,75.142044,419,"Heathridge - Connolly",2880,72.83073,8071,121,4071,1408,4000,75.08661,66.92308,689,6921,80.591354,88.129745,1449,79.193756,1277,84,1024,435,1063,3464,5481,13.838551,650,607,22.28361,"505011074",60.81277,1319
838,2221,1625,691,255,79.78388,71.6805,304,"Stratton - Jane Brook",1772,71.24105,5066,52,2590,964,2476,71.36583,60.842106,545,4498,82.881775,85.99537,864,75.52245,743,48,597,289,673,2277,3397,15.335464,475,313,20.392157,"504031067",55.779816,812
2054,5889,3761,1774,640,76.92308,60.484146,646,"Beechboro",4530,63.680622,13440,123,6911,2933,6529,61.364006,51.751312,1232,12018,77.42584,83.24588,2668,68.98818,2221,88,1308,591,1540,6129,8291,11.253197,1142,782,19.21875,"504031057",52.435066,1989
2691,7317,5548,2763,1313,82.315155,77.07113,710,"Bayswater - Embleton - Bedford",6023,72.055,17658,192,9028,3585,8630,75.00338,61.64139,1233,14714,78.80045,88.31925,3433,78.63939,3032,155,1939,691,2089,7397,11571,9.503372,1121,1631,14.623001,"504011045",57.58313,2651
1152,4528,3297,1983,567,83.23763,76.860466,363,"Maylands",3769,68.66319,10039,119,4944,2580,5095,75.72347,69.77492,558,8882,72.05543,88.01947,2671,79.55415,2351,89,791,434,936,4354,7066,15.084745,622,590,20.987654,"504011046",65.053764,1299
2442,6894,4760,2215,1601,79.48941,70.56387,741,"Morley",5480,65.68387,17142,242,8647,3139,8495,69.90748,60.83062,1351,13703,76.03375,84.935394,3173,74.728165,2695,194,1604,747,1802,6809,10240,10.554951,1228,1838,15.115553,"504011047",54.84826,2370
1160,2386,1779,638,744,83.822296,73.58708,257,"Noranda",2000,68.534485,6437,175,3307,867,3130,71.58954,58.733624,500,4871,81.9242,84.597435,857,77.581604,725,77,795,269,843,2485,3779,9.367396,458,822,23.521505,"504011048",51.4,1029
458,2670,657,211,219,27.228464,71.76871,100,"Chidlow",727,73.36244,3953,43,1064,294,2889,73.48993,54.929577,435,3564,45.271122,15.603329,1442,38.83277,225,32,336,78,359,894,1384,18.82353,142,170,19.634703,"504021049",22.988506,793
1127,2031,1673,501,604,86.01674,71.776505,229,"Glen Forrest - Darlington",1747,75.59894,5435,141,2800,698,2635,75.428314,56.997456,413,4249,82.45614,89.695946,592,80.489525,531,96,852,224,846,2218,3420,16.494844,393,582,23.344372,"504021050",55.44794,1026
707,1617,1268,498,384,85.77613,73.88724,192,"Helena Valley - Koongamia",1387,71.8529,4146,74,2145,674,2001,73.89278,64.77612,317,3333,84.045586,88.79599,598,79.65797,531,45,508,217,590,1716,2655,10.489511,335,429,19.270834,"504021051",60.56782,702
0,0,0,0,0,0.0,0.0,0,"Malmalling - Reservoir",0,0.0,4,0,4,0,0,0.0,0.0,0,0,0.0,0.0,0,0.0,0,0,0,0,0,0,0,0.0,0,4,0.0,"504021052",0.0,0
1942,3865,2887,934,987,83.46701,70.12012,450,"Mundaring",3226,72.2966,9761,190,4909,1332,4852,73.1627,61.160713,803,7811,82.897606,86.7863,1226,78.26143,1064,138,1404,411,1522,3946,6113,14.330218,672,963,19.250254,"504021053",56.039852,1836
1581,3652,2520,965,954,78.17634,68.977844,406,"Swan View - Greenmount - Midvale",2855,67.42568,9385,157,4779,1399,4606,69.326,57.55725,734,7287,75.814865,81.57514,1384,73.76149,1129,112,1066,377,1163,3635,5375,9.79021,655,1144,16.457024,"504021054",55.31335,1534
0,0,0,0,0,0.0,0.0,0,"Avon Valley National Park",0,0.0,0,0,0,0,0,0.0,0.0,0,0,0.0,0.0,0,0.0,0,0,0,0,0,0,0,0.0,0,0,0.0,"504031055",0.0,0
692,1532,1169,429,289,84.986946,68.3121,205,"Bullsbrook",1302,74.27746,3708,74,1887,628,1821,71.193665,59.93789,351,3174,83.030304,91.17082,521,77.851295,475,33,514,193,548,1642,2471,13.469388,322,245,25.605536,"504031058",58.40456,660
1939,4668,3533,1276,533,82.28363,73.0395,705,"Currambine - Kinross",3841,76.328,10558,105,5357,1747,5201,74.23829,64.49208,1184,9427,85.98759,88.258064,1550,78.22213,1368,85,1480,692,1663,4759,7374,14.214046,1073,598,19.699812,"505011071",59.54392,1934
3255,10903,8191,4383,1005,84.27956,70.63658,1247,"Ellenbrook",9189,72.01229,24847,177,12939,6205,11908,69.76408,57.781673,2184,22644,85.64674,90.81278,5758,76.75323,5229,146,2344,1318,2536,11741,17380,12.186978,2281,1198,17.61194,"504031059",57.09707,2961
2156,4457,3545,1317,1182,86.964325,76.25941,515,"Duncraig",3876,73.144714,11582,280,5943,1727,5639,76.08929,63.40206,916,9116,84.05419,90.50555,1622,81.40632,1468,159,1577,492,1613,4659,7421,12.383178,776,1284,23.688663,"505011072",56.222706,1919
452,857,668,204,193,85.88098,73.11828,96,"Gidgegannup",736,71.0177,2103,61,1053,279,1050,74.55357,66.666664,172,1753,84.33476,84.9315,219,80.09127,186,33,321,110,393,896,1404,21.019108,165,157,31.606218,"504031060",55.813953,466
493,1303,976,462,262,83.42287,75.12195,113,"Hazelmere - Guildford",1087,72.81947,3163,44,1598,615,1565,74.277016,59.2233,231,2617,84.22091,89.02655,565,78.83072,503,33,359,122,427,1314,2063,11.619719,206,284,16.793894,"504031061",48.917747,507
1172,3414,2339,1199,479,79.08611,71.58209,365,"Lockridge - Kiara",2700,63.65188,7849,74,3956,1675,3893,67.60116,54.812397,671,6874,75.24842,87.286064,1636,73.30521,1428,58,746,336,833,3460,5039,11.693548,613,496,15.448852,"504031062",54.396423,1107
702,1627,1116,401,423,79.47142,64.886734,193,"Middle Swan - Herne Hill",1293,67.948715,4103,94,2053,618,2050,67.22891,55.0,335,3287,76.532135,79.29374,623,73.28871,494,51,477,187,512,1660,2409,12.977099,340,393,22.222221,"504031065",57.61194,669
1126,3302,2100,936,638,73.44034,67.33813,355,"Midland - Guildford",2425,64.920074,7881,107,3941,1390,3940,67.07122,58.211384,668,6433,69.29895,79.181625,1393,70.34043,1103,75,731,358,860,3131,4525,9.259259,615,810,16.77116,"504031066",53.14371,1241
1668,4058,3081,1349,1125,85.18975,76.99772,406,"Greenwood - Warwick",3457,71.642685,10413,216,5230,1752,5183,76.66086,62.93823,711,8077,80.41505,88.365654,1805,80.94589,1595,160,1195,377,1240,4019,6538,13.212221,599,1211,19.2,"505011073",57.102673,1542
1261,3091,2407,1022,495,86.41216,73.52518,368,"The Vines",2671,72.482155,7299,137,3713,1390,3586,73.47375,64.16,632,6367,83.22204,92.7042,1261,79.75499,1169,70,914,401,997,3276,5078,16.018307,625,437,27.676767,"504031068",58.227848,1198
0,0,0,0,0,0.0,0.0,0,"Walyunga National Park",0,0.0,0,0,0,0,0,0.0,0.0,0,0,0.0,0.0,0,0.0,0,0,0,0,0,0,0,0.0,0,0,0.0,"504031069",0.0,0
1451,2923,2317,753,290,85.015396,76.993866,389,"Iluka - Burns Beach",2485,74.293594,6602,65,3389,978,3213,74.59755,68.53767,659,6029,88.078545,92.4821,838,79.64837,775,22,1078,464,1256,3106,4802,7.7738514,677,283,22.413794,"505011076",59.02883,1426
1750,4646,3392,1363,764,78.34696,74.84898,584,"Joondalup - Edgewater",3640,74.91428,10957,141,5547,1821,5410,73.43581,59.446564,1093,9265,82.283,81.827896,1871,75.898544,1531,95,1311,623,1384,4619,7032,10.237069,1048,928,18.455498,"505011077",53.430923,1682
1707,3408,2636,841,738,84.59507,75.0223,445,"Hillarys",2883,72.46632,8442,164,4296,1121,4146,74.421234,63.865547,779,6950,85.57026,87.90787,1042,79.41007,916,102,1237,456,1358,3542,5519,13.527851,714,754,22.222221,"505011075",57.12452,1587
1240,3872,3207,1895,598,83.161156,78.63071,288,"Tuart Hill - Joondanna",3220,70.241936,9570,99,5100,2410,4470,76.64914,64.98127,459,8056,71.92164,88.082016,2341,79.779045,2062,94,871,347,771,4184,6427,10.262009,534,916,16.555183,"505021095",62.7451,1072
1915,3865,3090,1117,1002,85.588615,77.24758,428,"Kingsley",3308,74.51697,10199,197,5332,1446,4867,77.501884,65.65495,758,7852,83.2273,90.275764,1378,81.48242,1244,135,1427,411,1439,3987,6398,10.037175,626,1345,19.660679,"505011078",56.46438,1729
1620,3305,2675,931,783,85.96066,74.06523,399,"Mullaloo - Kallaroo",2841,72.96296,8466,173,4378,1257,4088,75.47968,65.81709,687,6849,83.695656,90.488655,1146,80.53731,1037,123,1182,439,1232,3544,5516,14.748201,667,834,22.09451,"505011079",58.0786,1472
1539,2810,2278,704,843,87.72242,78.83539,354,"Sorrento - Marmion",2465,72.449646,7555,195,3902,893,3653,76.442955,60.036495,614,5790,85.39407,90.40591,813,81.9171,735,130,1115,329,1181,2980,4743,14.099783,548,922,23.131672,"505011082",57.654724,1383
1593,3079,2415,687,539,84.21565,74.91821,461,"Woodvale",2593,74.5135,7423,106,3805,917,3618,75.6342,68.81406,768,6272,86.04493,90.49881,842,79.84694,762,71,1187,470,1264,3193,5008,11.601307,683,612,19.666048,"505011083",60.026043,1469
1297,2536,1947,561,508,85.01577,73.81579,374,"Ocean Reef",2156,74.47957,6162,117,3118,760,3044,74.45507,61.648746,591,5151,85.77371,85.32974,743,79.654434,634,76,966,344,1031,2615,4103,15.109344,558,503,23.031496,"505011080",63.282574,1202
1037,2610,1990,877,513,84.44444,74.32204,249,"Padbury",2204,73.28833,6272,106,3149,1180,3123,75.89626,67.90124,453,5232,80.41349,89.66074,1238,80.16055,1110,78,760,275,739,2622,4194,14.800759,405,527,20.662767,"505011081",54.96689,919
1652,4601,3400,1697,1225,82.721146,75.79276,469,"Balcatta - Hamersley",3806,69.79419,11928,189,6102,2239,5826,73.97737,57.87234,783,9197,75.844154,86.91835,2278,78.35164,1980,142,1153,408,1168,4596,7206,9.428951,705,1506,15.428572,"505021084",59.897827,1540
0,0,0,0,0,0.0,0.0,0,"Herdsman",0,0.0,0,0,0,0,0,0.0,0.0,0,0,0.0,0.0,0,0.0,0,0,0,0,0,0,0,0.0,0,0,0.0,"505021087",0.0,0
1871,6519,3387,1762,861,68.262,59.068054,630,"Balga - Mirrabooka",4450,51.95083,14543,118,7163,2983,7380,55.198826,44.071762,1372,12655,62.56517,77.48529,3229,61.928093,2502,88,972,565,1200,6136,7837,8.568646,1282,1027,13.704994,"505021085",45.918365,1918
3101,7318,5445,2198,1933,81.62066,72.589165,726,"Dianella",5973,70.654625,19298,365,10047,3028,9251,72.01428,57.26257,1401,14879,79.99298,84.843544,3068,76.73903,2603,236,2191,820,2279,7561,11418,9.493162,1432,2486,18.882566,"505021086",51.82013,2849
1804,5216,4432,2485,792,83.85736,81.79723,447,"Innaloo - Doubleview",4374,70.34368,12952,134,6944,3038,6008,77.740746,65.774155,752,10917,76.47791,89.744484,2857,80.663185,2564,113,1269,565,1229,5701,8806,9.090909,859,1243,16.919191,"505021088",59.44149,1607
2579,5717,4689,1894,1487,88.29806,77.46421,598,"Karrinyup - Gwelup - Carine",5048,75.49438,15106,327,7902,2445,7204,76.41786,56.38489,1032,11853,84.62167,91.69643,2240,82.14798,2054,221,1947,627,2069,6136,9737,12.514156,1112,1766,21.990585,"505021089",57.945736,2445
1493,5986,3995,2484,780,76.6121,71.54378,531,"Nollamara - Westminster",4586,60.616207,13679,98,6913,3472,6766,67.78079,55.005383,951,11880,66.55173,83.458855,3585,72.23064,2992,95,905,511,965,5894,8581,9.3228655,929,1019,12.564102,"505021090",55.83596,1450
0,4,0,0,0,100.0,0.0,0,"Osborne Park Industrial",4,0.0,4,0,0,0,4,0.0,0.0,0,4,0.0,100.0,4,100.0,4,0,0,0,0,0,4,0.0,0,0,0.0,"505021091",0.0,0
1569,5241,4404,2570,686,86.9109,84.20708,454,"Scarborough",4555,75.71702,12159,146,6232,3052,5927,82.53373,70.34965,692,10577,80.19481,90.39548,3009,84.70266,2720,143,1188,503,1235,5336,8959,15.959822,715,896,21.282799,"505021092",65.60693,1540
1619,4476,3309,1634,921,84.20464,76.39084,458,"Stirling - Osborne Park",3769,67.078445,10912,196,5515,2139,5397,73.58239,63.734776,765,8973,77.74817,88.1448,2210,78.88109,1948,118,1086,471,1167,4497,7078,11.591355,739,1018,21.281216,"505021093",59.86928,1501
1037,2199,1802,726,641,86.08459,79.60526,207,"Trigg - North Beach - Watermans Bay",1893,72.70974,5895,146,3055,912,2840,77.20651,61.03896,359,4533,79.91927,88.10365,849,81.51334,748,87,754,235,792,2334,3695,12.066574,385,721,22.77691,"505021094",57.660168,991
1762,4024,3171,1258,1074,82.15706,76.56725,449,"Wembley Downs - Churchlands - Woodlands",3306,74.68785,10608,224,5510,1643,5098,76.04317,59.60784,967,8194,83.24125,89.42577,1428,79.04565,1277,141,1316,456,1356,4170,6477,10.522388,765,1340,20.856611,"505021096",46.432266,1629
921,2778,1505,703,484,67.5666,59.677418,254,"Girrawheen",1877,54.28882,6454,69,3192,1178,3262,56.472797,45.053005,581,5443,62.282608,76.82067,1277,62.134853,981,47,500,255,573,2665,3382,8.9184065,566,527,14.256198,"505031102",43.717728,920
1776,4702,3724,1761,1163,83.45385,76.565216,416,"Yokine - Coolbinia - Menora",3924,71.62162,12403,212,6538,2300,5865,75.43042,62.36934,777,9639,80.0,87.02702,2220,79.34433,1932,154,1272,537,1364,4937,7648,9.618988,861,1601,18.22872,"505021097",53.539253,1705
1505,3944,2277,909,617,72.565926,61.37745,462,"Alexander Heights - Koondoola",2862,61.79402,9013,112,4452,1481,4561,60.51023,49.16345,915,7707,73.938995,77.120316,1521,66.67964,1173,56,930,382,1115,3763,5139,8.127722,777,689,18.15235,"505031098",50.491802,1508
1619,5259,4029,2088,358,82.71535,72.550385,661,"Carramar",4350,73.008026,11687,76,6070,2878,5617,70.97058,60.16949,1133,10936,83.785614,89.668175,2652,76.61851,2378,49,1182,710,1235,5677,8379,12.468193,1180,393,21.22905,"505031100",58.340687,1474
1360,4281,3036,1495,326,78.88344,68.57798,535,"Clarkson",3377,66.98529,9485,76,4878,2180,4607,67.78299,61.022366,974,8760,78.5832,86.574295,2093,73.20776,1812,57,911,573,954,4479,6413,14.285714,939,399,23.312883,"505031101",54.92813,1214
2690,8165,6069,3061,885,83.79669,74.513145,959,"Madeley - Darch - Landsdale",6842,72.49071,18535,199,9485,4108,9050,71.77152,57.539204,1742,16621,85.397896,90.68901,3759,77.67884,3409,104,1950,954,2275,8456,12911,10.1069,1658,1029,22.485876,"505031103",55.051666,2664
1307,3377,2237,955,617,74.859344,68.60632,375,"Marangaroo",2528,63.351185,8144,93,4150,1392,3994,65.56272,54.698456,757,6789,75.06093,81.78545,1389,70.187065,1136,64,828,390,924,3412,4765,8.672087,713,738,15.072933,"505031104",49.537647,1231
2700,6056,4471,1578,807,81.80317,70.73061,877,"Mindarie - Quinns Rocks - Jindalee",4954,74.51852,13958,146,7095,2231,6863,71.6966,61.149426,1521,12292,85.37058,88.40654,1958,76.67589,1731,83,2012,798,2200,6236,9425,9.662398,1305,859,18.091698,"505031105",57.659435,2577
398,1870,1669,1142,77,91.283424,84.7181,173,"Casey",1707,75.62814,4081,18,2134,1348,1947,81.37494,70.491806,250,3921,85.39326,95.88608,1264,86.10049,1212,11,301,215,304,2051,3376,13.253012,305,83,23.376623,"801041036",69.2,356
364,752,644,273,119,89.893616,80.29412,75,"North Coogee",676,72.25275,1807,41,936,340,871,77.871826,67.479675,112,1579,84.39307,91.15646,294,83.59721,268,25,263,83,292,827,1320,22.93578,123,109,34.45378,"507011158",66.96429,346
0,0,0,0,0,0.0,0.0,0,"Neerabup National Park",0,0.0,0,0,0,0,0,0.0,0.0,0,0,0.0,0.0,0,0.0,0,0,0,0,0,0,0,0.0,0,0,0.0,"505031106",0.0,0
1762,3555,2717,920,733,83.431786,76.794655,468,"Leeming",2966,71.16913,8681,170,4393,1198,4288,74.09326,61.95191,817,7222,82.223656,88.664986,1191,78.69012,1056,105,1254,438,1272,3667,5683,14.46281,707,726,23.19236,"507041180",57.28274,1547
1394,4043,3077,1484,550,85.53055,73.647644,500,"Tapping - Ashby - Sinagra",3458,73.81635,9482,98,4889,2015,4593,73.647675,65.40962,814,8221,85.40581,90.82715,1886,79.49155,1713,61,1029,503,1147,4178,6535,8.579466,769,711,17.818182,"505031107",61.42506,1343
589,2507,2007,1161,103,86.83685,74.614395,346,"Alkimos - Eglinton",2177,75.721565,5432,27,2822,1556,2610,74.25083,67.92115,521,5210,86.97318,92.21311,1464,80.3071,1350,21,446,379,454,2703,4184,17.647058,558,119,26.213593,"505031255",66.41075,522
702,1783,1055,429,302,74.256874,61.02418,166,"Camillo - Champion Lakes",1324,62.535614,4151,50,2066,703,2085,60.182545,47.70115,334,3536,74.31059,78.42105,760,67.27941,596,21,439,166,512,1753,2379,6.709265,348,313,16.556292,"506011112",49.7006,689
2949,7997,6027,2863,1425,84.59422,75.2431,925,"Wanneroo",6765,68.63344,19341,268,9919,3805,9422,73.07226,64.12316,1538,16245,82.2311,89.26356,3707,78.74423,3309,182,2024,958,2263,8248,12792,10.891682,1494,1671,18.807018,"505031108",60.143044,2752
906,2434,1748,824,416,81.34757,65.18987,249,"Yanchep",1980,68.10155,5940,58,3090,1264,2850,65.91252,53.52697,451,5086,79.44711,87.923546,1151,73.299255,1012,49,617,258,661,2652,3728,11.187215,482,438,13.942307,"505031258",55.210644,832
98,270,156,44,49,80.74074,61.11111,34,"Carabooda - Pinjar",218,81.63265,557,18,238,72,319,74.28571,67.5,72,480,81.14754,88.1579,76,77.916664,67,5,80,27,99,210,374,17.857143,40,28,36.734695,"505031256",47.22222,122
932,3212,2093,1074,286,79.483185,63.36283,381,"Seville Grove",2553,65.55794,7111,49,3613,1695,3498,63.137257,54.65116,696,6527,79.13341,87.18731,1639,71.181244,1429,32,611,376,694,3315,4646,10.738256,688,298,17.132868,"506011117",54.74138,877
1515,4598,3117,1532,829,80.90474,71.857414,491,"Belmont - Ascot - Redcliffe",3720,65.9406,10831,155,5404,2132,5427,70.50441,62.273903,838,9019,75.36716,85.985855,2262,75.80663,1945,104,999,482,1129,4421,6837,10.579858,774,983,18.697226,"506021118",58.591885,1498
350,860,529,231,210,74.53488,62.601627,76,"Two Rocks",641,61.714287,2120,24,1050,369,1070,62.162163,50.757576,155,1711,71.05943,83.6478,318,68.381065,266,15,216,67,275,851,1170,7.5376883,132,199,11.428572,"505031257",49.032257,387
2000,5391,3258,1455,1063,71.71211,57.50988,570,"Armadale - Wungong - Brookdale",3866,57.05,13466,139,7012,2530,6454,57.047802,47.925488,1119,11102,68.79157,77.63371,2468,64.16862,1916,96,1141,566,1241,5711,7124,7.378939,1181,1301,13.0762,"506011110",50.93834,1804
1549,5651,4043,2302,690,77.88002,77.19651,604,"East Victoria Park - Carlisle",4401,69.78696,12631,129,6290,2982,6341,73.939285,59.55176,1088,11119,72.10191,84.73104,2993,75.94208,2536,102,1081,558,1132,5468,8444,12.408759,937,822,18.695652,"506021119",55.514706,1570
0,0,0,0,0,0.0,0.0,0,"Ashendon - Lesley",0,0.0,0,0,0,0,0,0.0,0.0,0,0,0.0,0.0,0,0.0,0,0,0,0,0,0,0,0.0,0,0,0.0,"506011111",0.0,0
0,4,0,0,0,100.0,0.0,0,"Kewdale Commercial",4,0.0,4,0,0,0,4,0.0,0.0,0,4,100.0,0.0,0,100.0,0,0,0,0,4,0,4,0.0,0,0,0.0,"506021120",0.0,4
1486,6408,4765,2972,329,86.73533,73.02211,637,"Forrestdale - Harrisdale - Piara Waters",5558,70.995964,13736,73,6999,4070,6737,71.69726,63.119267,1022,13054,83.36857,92.38719,3967,79.07921,3665,50,1055,688,1183,6646,10323,14.164306,1090,353,22.18845,"506011113",62.328766,1419
0,24,0,0,0,0.0,0.0,0,"Perth Airport",0,0.0,32,0,8,8,24,0.0,0.0,0,32,0.0,0.0,12,0.0,0,0,0,0,0,8,0,0.0,0,0,0.0,"506021121",0.0,12
1258,3180,2025,803,731,77.64151,61.627014,363,"Kelmscott",2469,63.99046,7844,115,3933,1303,3911,64.367455,54.700855,645,6326,77.17742,79.84556,1295,71.04015,1034,97,805,320,957,3146,4494,12.325286,585,787,15.731874,"506011114",56.279068,1240
1547,3255,2547,888,515,81.19816,72.43067,418,"Canning Vale - West",2643,71.42857,7846,140,4076,1226,3770,70.8287,59.052246,791,6851,84.18741,85.15482,1098,75.75536,935,68,1105,486,1150,3596,5190,14.166667,823,480,27.184465,"506031125",52.8445,1366
1205,2412,1742,585,665,83.913765,70.14388,310,"Mount Nasura - Mount Richon - Bedfordale",2024,66.390045,6154,122,3077,834,3077,70.29863,66.97039,505,4890,82.31598,85.1198,793,77.01431,675,63,800,294,917,2478,3766,10.517529,439,599,18.345865,"506011115",61.38614,1114
0,0,0,0,0,0.0,0.0,0,"Canning Vale Commercial",0,0.0,0,0,0,0,0,0.0,0.0,0,0,0.0,0.0,0,0.0,0,0,0,0,0,0,0,0.0,0,0,0.0,"506031126",0.0,0
1032,2114,1697,601,545,87.65374,75.03121,237,"Roleystone",1853,73.54651,5422,145,2763,801,2659,76.85689,65.333336,396,4322,82.8629,89.393936,726,82.1379,649,92,759,245,822,2208,3550,16.576576,375,555,26.605505,"506011116",59.848484,992
2495,5709,3973,1470,1161,77.561745,67.03146,650,"Willetton",4428,68.8978,14032,251,7162,2193,6870,66.52713,50.38941,1460,11681,79.40403,87.188614,1967,71.92021,1715,137,1719,647,1812,5972,8401,11.512605,1284,1190,21.619293,"506031131",44.52055,2282
1432,6458,3629,2112,586,75.28647,63.980614,730,"Cannington - Queens Park",4862,59.217876,13729,121,6685,3301,7044,61.16636,49.833332,1354,12391,71.448,81.475365,3633,68.52554,2960,71,848,598,1051,5933,8491,9.441489,1200,752,20.648464,"506031127",53.91433,1471
2260,8347,5217,2793,1253,78.279625,69.065285,905,"Rivervale - Kewdale - Cloverdale",6534,64.823006,18903,194,9303,4044,9600,67.88549,59.522087,1548,16032,72.96512,83.76224,4391,73.29716,3678,137,1465,822,1757,7685,11751,8.467243,1381,1618,15.482841,"506021122",58.462532,2408
1470,5276,3636,1953,661,82.48673,75.0865,540,"Victoria Park - Lathlain - Burswood",4352,69.11565,11547,159,5610,2601,5937,73.46939,64.00911,917,10225,78.13526,86.84767,2836,78.122246,2463,105,1016,562,1190,4949,7988,15.885023,878,661,24.054462,"506021123",58.887676,1523
1524,7030,3674,1868,1135,65.533424,65.497894,958,"Bentley - Wilson - St James",4607,59.58005,16174,124,8009,2852,8165,59.143593,43.572987,2211,13242,67.91299,75.44803,3348,62.53587,2526,98,908,800,999,6212,8281,5.4535336,1836,1797,10.92511,"506031124",43.32881,1471
1755,4417,3045,1339,999,79.76002,69.5946,453,"Parkwood - Ferndale - Lynwood",3523,67.74929,11001,161,5585,1924,5416,69.55231,55.79399,870,8795,77.148315,85.88057,1976,74.678795,1697,127,1189,390,1212,4378,6568,10.521955,699,1207,16.116116,"506031128",52.068966,1571
1782,4038,2839,1033,1023,77.95939,69.18955,489,"Riverton - Shelley - Rossmoyne",3148,67.62065,10609,189,5548,1493,5061,67.4507,52.56959,1025,8247,80.227,84.16729,1339,72.59609,1127,110,1205,491,1343,4209,5987,8.215086,934,1339,18.475073,"506031129",47.707317,1674
0,3,0,0,3,200.0,0.0,0,"Welshpool",6,0.0,6,3,0,0,6,0.0,0.0,0,3,0.0,100.0,3,200.0,3,0,0,0,0,0,6,0.0,0,0,100.0,"506031130",0.0,0
2542,8277,5107,2418,772,71.74097,69.683,850,"Canning Vale - East",5938,68.4107,17441,183,8392,3470,9049,67.64239,56.11183,1873,15827,80.50485,73.96187,3829,69.78581,2832,87,1739,863,2073,7550,11045,10.332541,1538,842,23.704662,"506041133",45.38174,2575
2069,5994,3495,1603,1244,73.40674,58.418365,587,"Gosnells",4400,60.99565,14813,172,7575,2744,7238,58.51331,46.551723,1198,11967,69.66292,80.57475,2749,65.97309,2215,90,1262,540,1426,5973,7895,5.6179776,1160,1602,13.826366,"506041134",48.99833,2047
1879,6427,3551,1796,1019,74.62269,62.23146,699,"Beckenham - Kenwick - Langford",4796,57.317722,14394,182,6948,2886,7446,60.339848,50.535713,1347,12312,70.19937,81.190926,3174,67.79565,2577,112,1077,566,1338,5885,8347,10.536219,1120,1063,17.860647,"506041132",51.893097,1906
1429,4918,3622,1965,503,86.37658,71.247284,614,"Byford",4248,66.96991,11168,95,5747,2758,5421,69.04308,61.473087,932,10164,84.477615,90.9675,2646,77.430145,2407,49,957,651,1132,5246,7870,9.780439,1059,501,18.88668,"506061142",65.87983,1340
940,2057,1469,492,383,84.58921,70.28571,295,"Mundijong",1740,70.106384,4814,95,2374,700,2440,70.69297,61.643837,476,4135,84.40464,86.86709,632,77.605804,549,48,659,270,801,2078,3209,16.216217,438,296,24.804178,"506061143",61.97479,949
0,0,0,0,0,0.0,0.0,0,"Trafalgar (WA)",0,0.0,0,0,0,0,0,0.0,0.0,0,0,0.0,0.0,0,0.0,0,0,0,0,0,0,0,0.0,0,0,0.0,"511031284",0.0,0
2021,6192,4230,2139,641,81.976746,69.0,701,"Huntingdale - Southern River",5076,68.629395,13788,138,6955,3100,6833,67.228226,52.34842,1272,12484,84.05651,87.50851,2938,74.54342,2571,91,1387,613,1666,6292,9306,13.725491,1171,663,21.528862,"506041135",55.11006,1982
1371,4403,2307,1024,823,74.78992,57.206703,463,"Maddington - Orange Grove - Martin",3293,58.716267,10174,136,4948,1790,5226,57.921165,46.958637,860,8386,72.40238,78.74016,2032,66.77796,1600,92,805,386,1094,3983,5600,9.533679,822,965,16.524908,"506041136",53.837208,1511
587,1513,849,284,332,64.70588,67.780426,113,"Serpentine - Jarrahdale",979,71.20954,3338,63,1493,419,1845,70.86811,53.125,209,2711,67.26028,54.3554,574,67.42899,312,45,418,102,491,1198,1828,15.254237,192,295,18.975904,"506061144",54.066986,730
534,1300,739,272,351,86.46154,70.466324,96,"Morawa",1124,64.41948,2974,102,1323,386,1651,70.98943,51.23967,185,2341,78.97196,88.58351,473,79.581375,419,61,344,62,507,1041,1863,21.631207,121,282,29.05983,"511041291",51.89189,642
864,1677,1155,360,578,83.60167,67.28972,130,"Northampton - Mullewa - Greenough",1402,67.361115,4315,155,2060,535,2255,72.0524,59.313725,220,3280,73.13278,83.56998,493,77.95731,412,92,582,121,705,1603,2557,20.13129,204,457,26.816608,"511041292",59.090908,964
323,1506,1250,864,85,88.18061,86.31368,143,"Crace",1328,69.96904,3243,19,1652,1001,1591,80.28259,65.23605,244,3063,85.66553,94.427246,969,84.16585,915,8,226,152,251,1557,2578,8.421053,233,95,22.352942,"801041037",58.606556,293
2896,7381,4919,2008,1479,79.08143,64.60747,832,"Thornlie",5837,67.506905,17857,239,8997,3108,8860,66.544914,57.06052,1504,14773,77.9927,83.80618,3137,72.8085,2629,164,1955,792,2137,7392,10756,10.218068,1388,1605,16.159567,"506041137",55.31915,2740
1458,3266,2222,798,995,72.473976,67.914894,351,"Geraldton",2367,65.77503,8763,137,4502,1175,4261,67.59963,54.587154,629,6553,68.65358,74.31875,1211,70.02899,900,108,959,357,979,3287,4589,8.888889,654,1215,13.768845,"511041285",55.80286,1426
967,2473,1509,588,403,65.507484,62.8877,261,"Geraldton - East",1620,65.667015,5644,55,2768,935,2876,62.953693,51.11111,567,4870,73.049644,63.43852,919,64.25051,583,33,635,253,721,2397,3129,8.894878,495,371,13.647643,"511041286",46.031746,987
974,2256,1721,705,464,82.358154,71.42857,253,"Geraldton - North",1858,72.4846,5552,97,2832,987,2720,71.29246,58.719646,437,4670,78.540306,87.34739,901,76.638115,787,44,706,266,721,2414,3579,10.526316,453,418,20.905172,"511041287",57.894737,918
1274,2943,2418,1013,513,83.86001,75.14837,351,"Geraldton - South",2468,74.960754,7179,111,3723,1348,3456,75.657074,65.15679,607,6139,82.77972,88.842285,1192,79.58951,1059,76,955,374,947,3196,4886,14.421252,574,527,21.637426,"511041288",57.82537,1144
515,936,658,229,417,79.166664,67.75148,75,"Irwin",741,61.359222,2742,68,1389,338,1353,67.21144,51.587303,161,1915,73.41513,83.56644,286,73.05483,239,48,316,65,359,979,1399,11.707317,126,410,16.306955,"511041289",46.58385,489
310,1077,443,188,156,83.19406,63.299664,71,"Meekatharra",896,63.225807,2025,60,792,297,1233,62.57062,32.673267,130,1785,76.16822,84.58574,519,75.01401,439,26,196,33,326,708,1339,30.952381,101,84,38.46154,"511041290",54.615383,428
2048,5930,4192,2017,921,83.693085,71.499466,662,"Forrestfield - Wattle Grove",4963,69.58008,13890,187,7039,2821,6851,70.347374,58.44037,1119,11889,81.8001,88.17857,2800,77.00395,2469,113,1425,637,1645,5959,9155,10.462963,1090,1080,20.304018,"506051138",59.159966,2011
1416,3810,2760,1205,675,84.04199,70.38551,482,"High Wycombe",3202,71.82204,9116,120,4631,1712,4485,72.06266,65.52707,759,7640,81.63265,88.147705,1679,78.03665,1480,78,1017,460,1120,3830,5962,9.737827,702,801,17.777779,"506051139",63.504612,1372
813,1926,958,414,350,50.623055,46.205357,154,"Bridgewater - Gagebrook",975,41.82042,4842,20,2566,896,2276,43.23105,35.897434,485,4142,50.901527,60.27778,720,46.668278,434,22,340,182,367,2216,1933,6.285714,507,350,5.714286,"601011001",31.752577,721
1446,2802,2501,1055,1063,84.51106,86.26329,284,"Howrah - Tranmere",2368,73.443985,8283,145,4418,1223,3865,79.87863,61.471863,523,5933,79.86633,90.85028,1082,82.06641,983,100,1062,284,956,3131,4869,7.7700076,462,1287,13.640639,"601021007",54.302105,1197
2117,4219,3258,1077,1466,86.51339,73.165764,528,"Kalamunda - Maida Vale - Gooseberry Hill",3650,70.19367,11731,289,6046,1472,5685,74.01181,62.36162,884,8621,82.249115,88.90533,1352,80.12991,1202,188,1486,507,1631,4402,6908,11.435523,813,1644,19.713507,"506051140",59.728508,1983
1617,3337,2446,784,996,83.30836,72.86246,416,"Lesmurdie - Bickley - Carmel",2780,72.35622,8785,206,4452,1076,4333,71.92002,52.259888,812,6738,83.1565,88.888885,1017,77.560104,904,122,1170,370,1254,3401,5226,11.607992,708,1051,20.682732,"506051141",51.231525,1508
626,1651,1313,601,290,82.98001,80.13333,203,"Brighton - Pontville",1370,69.32907,4003,55,2062,750,1941,75.41643,67.12329,347,3392,77.83251,91.79856,695,79.09788,638,33,434,245,474,1741,2683,10.280374,365,321,18.965517,"601011002",58.501442,609
639,1351,1137,490,291,85.71429,86.419754,133,"Old Beach - Otago",1158,70.42254,3388,54,1746,567,1642,77.71702,69.6498,221,2814,80.26534,92.40987,527,81.5565,487,18,450,179,484,1463,2295,6.360424,257,283,18.556702,"601011003",60.180996,603
877,1668,1377,518,608,78.83693,80.81123,165,"Bellerive - Rosny",1315,70.69556,4863,85,2587,641,2276,76.330376,63.986015,329,3472,76.8407,82.939186,592,77.53456,491,56,620,183,574,1804,2692,7.1519794,286,783,13.980263,"601021004",50.151978,747
1193,2353,1960,719,591,85.67786,86.31453,263,"Cambridge",2016,77.28416,5925,102,2981,833,2944,81.159424,63.753212,451,4768,83.51931,91.994576,737,83.38926,678,71,922,248,973,2415,3976,12.544169,389,566,17.258883,"601021005",58.314857,1165
460,957,867,371,258,81.08673,87.914696,86,"Geilston Bay - Risdon",776,77.17391,2594,25,1379,422,1215,83.76811,71.895424,161,1992,79.81221,87.83784,370,82.47992,325,31,355,110,340,1035,1643,9.011628,153,344,9.689922,"601021006",53.41615,426
1668,4426,3709,1773,817,83.00949,78.94034,482,"Como",3674,69.184654,11351,190,6108,2246,5243,74.642784,61.327015,866,9395,78.72024,87.72563,2216,78.58435,1944,135,1154,647,1058,4969,7383,11.852502,1055,1139,23.255814,"506071145",55.6582,1344
996,2538,1833,814,510,77.65958,72.163124,251,"Coolbellup",1971,69.97992,6280,78,3232,1128,3048,70.88167,54.978355,455,5124,73.31933,83.46596,1131,74.23888,944,68,697,254,698,2586,3804,10.526316,462,646,15.294118,"507011153",55.164837,952
1308,3119,2033,866,825,65.56589,65.35849,296,"Glenorchy",2045,57.33945,8426,62,4482,1325,3944,61.3273,51.31965,629,6434,61.58192,73.86091,1251,63.382034,924,67,750,350,763,3315,4078,5.7412167,682,1167,7.5151515,"601031017",47.058823,1239
679,1346,1047,414,389,78.751854,75.0,172,"Montrose - Rosetta",1060,67.45213,3741,50,2006,552,1735,69.846565,54.850746,269,2845,75.25773,80.80808,495,74.05975,400,28,458,147,438,1499,2107,5.5226827,268,507,12.853471,"601031018",63.94052,582
681,1662,1115,484,296,68.59206,68.555244,146,"Moonah",1140,65.63876,4065,28,2107,706,1958,65.51116,50.15873,324,3364,65.74924,78.36257,684,67.033295,536,26,447,158,430,1702,2255,6.419753,315,405,9.459459,"601031019",45.06173,654
1413,3694,2308,869,745,70.87168,69.29825,447,"Manning - Waterford",2618,66.31281,8966,174,4527,1254,4439,64.83146,45.68869,1178,7254,78.87439,79.84496,1290,67.907364,1030,94,937,408,967,3560,4926,9.720786,893,967,23.355705,"506071146",37.94567,1226
2145,5371,3989,1712,1072,83.31782,75.08772,551,"South Perth - Kensington",4475,69.32401,13001,336,6558,2280,6443,74.2554,62.5132,1088,10743,79.44926,87.42464,2322,78.78619,2030,198,1487,592,1558,5372,8464,16.694773,947,1186,31.343283,"506071147",50.643383,1961
1722,5521,4335,2304,457,84.87593,75.86434,620,"Banjup",4686,73.228806,12346,104,6368,3037,5978,74.10256,63.88634,1083,11371,85.04902,91.732,2806,79.33339,2574,73,1261,697,1388,5850,9021,14.092664,1091,518,22.757113,"507011148",57.248383,1632
0,0,0,0,0,0.0,0.0,0,"Bibra Industrial",0,0.0,0,0,0,0,0,0.0,0.0,0,0,0.0,0.0,0,0.0,0,0,0,0,0,0,0,0.0,0,0,0.0,"507011150",0.0,0
0,0,0,0,0,0.0,0.0,0,"Bibra Lake",0,0.0,0,0,0,0,0,0.0,0.0,0,0,0.0,0.0,0,0.0,0,0,0,0,0,0,0,0.0,0,0,0.0,"507011151",0.0,0
1214,3136,2190,1033,754,75.063774,71.98606,245,"Hamilton Hill",2354,65.15651,7971,95,4081,1435,3890,69.36965,56.496063,488,6293,69.949066,80.95238,1470,72.207214,1190,79,791,287,824,3157,4544,8.549784,508,924,12.599469,"507011154",50.204918,1178
0,3,4,4,0,100.0,100.0,0,"East Arm",3,0.0,7,0,4,4,3,100.0,0.0,0,7,100.0,0.0,0,100.0,0,0,0,0,3,4,7,0.0,0,0,0.0,"701021017",0.0,3
1246,2728,2161,849,637,84.93402,76.62455,334,"Coogee",2317,72.87319,6857,121,3492,1108,3365,74.775085,62.873135,556,5618,82.207016,89.830505,1003,79.708084,901,67,908,337,961,2890,4478,11.129568,536,602,18.99529,"507011152",60.07194,1169
5,3,0,0,0,100.0,0.0,0,"Henderson",3,0.0,8,0,5,0,3,0.0,0.0,0,8,100.0,0.0,0,37.5,0,0,0,0,3,5,3,0.0,0,0,0.0,"507011155",0.0,3
307,1524,1205,735,67,90.28871,79.718,185,"Lyons (NT)",1376,80.456024,3174,20,1583,922,1591,78.964615,69.36027,275,3050,89.51842,95.42411,896,84.62295,855,17,247,206,316,1526,2581,29.824562,297,57,29.850746,"701021021",67.27273,353
1483,3862,2735,1182,593,80.21751,73.09833,459,"South Lake - Cockburn Central",3098,68.30749,9019,117,4564,1617,4455,71.13134,61.073826,809,7707,79.56679,85.1319,1668,75.68444,1420,85,1013,455,1102,3845,5833,11.821975,745,719,19.730185,"507011159",56.736713,1385
1215,2949,2137,918,816,80.67142,70.61539,290,"Spearwood",2379,64.44444,7814,88,4049,1300,3765,69.18096,60.97561,482,6038,77.20392,84.375,1344,74.79298,1134,86,783,350,867,3089,4516,8.958333,574,960,10.784314,"507011160",60.165974,1123
223,630,454,209,99,83.492065,79.166664,89,"Moil",526,77.578476,1400,17,671,264,729,78.006874,61.05263,135,1212,82.37885,86.9403,268,80.858086,233,14,173,58,187,582,980,15.730337,95,89,17.171717,"701021024",65.92593,227
1298,4766,3612,2096,334,85.480484,73.595505,502,"Success - Hammond Park",4074,71.956856,10518,83,5418,2848,5100,72.18225,63.286713,820,9770,83.5673,90.56673,2735,78.669395,2477,39,934,543,1012,5004,7686,9.42029,858,414,24.8503,"507011161",61.219513,1211
915,2471,1744,802,281,80.37232,71.60714,282,"Yangebup",1986,70.92896,5540,59,2788,1120,2752,70.152855,59.201775,493,4957,79.363335,86.4105,1067,75.24712,922,26,649,267,723,2486,3730,8.609271,451,302,20.99644,"507011163",57.20081,911
914,2637,2045,1018,294,84.07281,73.82161,280,"Beeliar - Wattleup",2217,72.97593,6005,64,3074,1379,2931,73.27123,64.859436,464,5428,81.91964,89.19342,1277,78.51879,1139,37,667,323,734,2791,4262,13.074205,498,283,21.768707,"507011259",60.344826,896
388,897,620,190,184,77.48049,72.24335,106,"Jandakot",695,72.42268,2096,60,1015,263,1081,74.42977,61.53846,274,1730,85.789474,83.53909,243,76.01156,203,37,281,112,326,833,1315,20.32967,182,182,32.608696,"507011260",38.68613,380
1101,2197,1866,658,482,84.3878,79.4686,217,"East Fremantle",1854,77.11172,5601,120,2922,828,2679,79.33673,63.120567,391,4549,82.20974,86.585365,738,81.776215,639,92,849,267,878,2352,3720,16.14035,423,570,24.896265,"507021164",55.498722,1068
1903,4467,3625,1655,1050,81.17305,78.32465,353,"Fremantle",3626,71.09827,11431,270,5914,2113,5517,77.11125,64.52555,605,9168,70.78834,84.17911,2010,79.09032,1692,175,1353,442,1311,4701,7251,14.42704,685,1213,25.714285,"507021165",58.347107,1852
1937,4272,3390,1453,1030,79.42416,75.835075,375,"Fremantle - South",3393,70.21167,11168,179,5866,1916,5302,74.374725,60.567375,670,8830,73.79349,83.73627,1820,76.817665,1524,150,1360,427,1315,4558,6783,11.46789,705,1308,17.378641,"507021166",55.97015,1782
0,3,0,0,0,100.0,0.0,0,"O'Connor (WA)",3,0.0,3,0,0,0,3,0.0,0.0,0,3,0.0,100.0,3,100.0,3,0,0,0,0,0,3,0.0,0,0,0.0,"507021167",0.0,0
1099,2546,1515,556,660,70.58131,57.8564,275,"Cooloongup",1797,57.32484,6527,57,3321,961,3206,58.471634,52.542374,536,5137,68.73185,77.27738,977,64.47343,755,50,630,279,710,2591,3312,6.849315,531,730,8.636364,"507051186",51.30597,1033
1051,4518,3183,1946,245,82.02744,69.72411,493,"Bertram - Wellard (West)",3706,68.22074,9712,50,4949,2791,4763,67.737816,57.29288,855,9217,77.864075,89.66958,2633,74.742325,2361,29,717,491,802,4699,6889,11.6,857,250,20.408163,"507031169",57.66082,1030
756,2205,1253,560,442,68.48073,56.737587,204,"Calista",1510,56.48148,5460,35,2813,987,2647,56.087734,48.065174,434,4439,66.82809,76.084656,945,62.243748,719,30,427,236,552,2234,2763,5.1813474,491,579,7.918552,"507031170",47.00461,826
516,1315,869,336,299,83.4981,66.932274,175,"Katanning",1098,71.12403,3173,71,1559,502,1614,72.23608,61.62162,266,2518,77.79661,85.62092,459,78.11755,393,52,367,114,459,1203,1967,14.606742,185,356,23.74582,"509011230",65.789474,590
538,1169,856,313,354,94.26861,71.13636,87,"Kojonup",1102,72.30483,2953,144,1430,440,1523,77.11712,59.090908,146,2279,82.35294,89.01869,428,85.91487,381,76,389,78,490,1110,1958,23.75,132,320,40.677967,"509011231",59.589043,595
9,18,9,0,8,61.11111,0.0,5,"Hope Valley - Postans",11,100.0,44,0,18,0,26,75.0,0.0,5,30,30.0,100.0,3,66.666664,3,0,9,0,3,12,20,0.0,3,6,0.0,"507031172",100.0,10
614,1567,1023,388,410,82.51436,70.80292,153,"Merredin",1293,69.543976,3775,126,1798,548,1977,73.809525,59.375,348,2953,78.279884,89.49343,533,78.42872,477,75,427,133,537,1386,2316,18.203884,224,412,30.731707,"509021240",43.96552,686
575,1472,962,371,348,91.71196,70.936905,147,"Moora",1350,72.17391,3427,146,1607,523,1820,75.273865,46.666668,244,2750,83.3581,89.36937,555,84.07273,496,92,415,84,561,1278,2312,27.963526,180,329,41.95402,"509021241",60.245903,673
374,1050,584,221,278,93.333336,67.173256,71,"Mukinbudin",980,71.92513,2320,110,992,329,1328,74.11167,54.117645,107,1838,83.11445,86.82927,410,85.09249,356,48,269,46,443,788,1564,23.529411,85,204,39.568344,"509021242",66.35514,533
561,3319,924,312,229,67.39982,73.06792,476,"Howard Springs",2237,77.00535,4887,73,1339,427,3548,77.06422,70.14218,718,4518,72.19464,60.28858,1594,69.964584,961,32,432,148,727,1199,3161,22.857143,211,140,31.87773,"701031031",66.295265,1007
5,0,12,7,0,0.0,100.0,0,"Kwinana Industrial",0,100.0,12,0,12,7,0,100.0,0.0,0,12,0.0,0.0,0,100.0,0,0,5,0,0,12,12,0.0,0,0,0.0,"507031173",0.0,0
1217,3272,1916,855,639,71.454765,59.00621,324,"Parmelia - Orelia",2338,57.60066,7846,67,3935,1449,3911,58.43245,53.344208,661,6551,67.89216,80.461426,1387,64.93665,1116,33,701,327,831,3279,4254,5.030488,613,656,10.485133,"507031174",49.01664,1224
2120,4605,3846,1504,1187,85.993484,78.66109,514,"Melville",3960,74.00944,12327,228,6535,1912,5792,76.29439,62.14073,916,9646,84.10256,90.741806,1739,80.924736,1578,146,1569,627,1640,5041,7806,9.772423,1009,1494,19.208088,"507041181",56.113537,1950
565,2706,1314,670,207,55.728012,75.706215,238,"Casuarina - Wandi",1508,66.19469,4881,27,1968,885,2913,72.676994,69.55307,541,4514,66.51446,53.448277,1508,62.516617,806,21,374,249,437,1808,2822,13.125,358,160,13.043478,"507031261",43.992607,657
1045,2808,2130,960,321,86.32478,84.95575,326,"Humpty Doo",2424,80.0,5955,90,2826,1130,3129,83.008575,65.21739,513,5374,82.52912,92.95517,1093,84.74135,1016,79,836,255,992,2566,4554,30.384615,391,260,28.037384,"701031032",63.54776,1202
0,19,3,3,0,84.210526,100.0,16,"Koolpinyah",16,0.0,22,0,3,3,19,100.0,0.0,16,22,0.0,0.0,0,86.36364,0,0,0,0,0,3,19,0.0,0,0,0.0,"701031033",100.0,3
1539,3240,2499,929,888,84.81481,72.86275,374,"Applecross - Ardross",2748,65.88694,8675,232,4547,1275,4128,70.994316,58.781868,709,6760,79.84104,90.40977,1147,77.61834,1037,141,1014,415,1105,3520,5247,13.729309,706,1027,26.126125,"507041175",52.75035,1384
498,1155,858,313,265,80.8658,74.346794,155,"Bateman",934,72.289154,2932,46,1512,421,1420,72.95918,56.420235,296,2331,83.371826,87.323944,426,76.87688,372,40,360,145,361,1176,1792,11.904762,257,336,17.35849,"507041176",52.364864,433
1795,3907,3375,1462,942,85.00128,77.1504,401,"Bicton - Palmyra",3321,73.983284,10550,197,5701,1895,4849,76.739426,63.276836,679,8305,80.0992,88.60681,1615,80.62613,1431,137,1328,448,1292,4398,6696,10.514198,708,1303,20.91295,"507041177",59.057438,1613
968,1889,1375,430,475,82.159874,72.75803,297,"Winthrop",1552,67.045456,4792,119,2428,591,2364,69.02611,55.6582,538,3881,82.98397,85.74074,540,75.41871,463,55,649,241,673,1992,2927,12.614679,433,436,25.052631,"507041184",55.20446,811
2001,4226,3251,1237,1138,83.74349,72.89334,495,"Booragoon",3539,68.115944,11397,251,6033,1697,5364,71.27823,57.821552,953,8787,82.51624,88.35443,1580,77.27325,1396,152,1363,499,1397,4561,6790,10.326087,863,1472,22.056238,"507041178",51.94124,1693
1007,2193,1596,597,787,80.66576,71.49701,226,"Bull Creek",1769,67.72592,6230,145,3250,835,2980,69.421486,51.203503,505,4492,79.612755,86.296295,810,74.91095,699,83,682,234,699,2299,3365,8.727655,457,951,18.424397,"507041179",44.752476,878
1614,3932,2761,966,991,75.20346,71.29151,520,"Murdoch - Kardinya",2957,70.38414,10071,156,5148,1355,4923,69.42419,53.76984,1085,7909,81.29032,78.99449,1452,72.297386,1147,117,1136,542,1134,3977,5718,9.99146,1008,1171,15.741675,"507041182",47.926266,1395
519,1376,1006,525,237,75.0,74.67995,135,"Willagee",1032,63.00578,3573,26,1960,703,1613,67.88124,48.076923,263,2858,69.318184,84.10104,673,71.30861,566,29,327,125,305,1482,2038,6.0669456,260,478,10.970464,"507041183",51.3308,440
2809,9665,7157,3767,1007,85.25608,68.72833,1196,"Baldivis",8240,68.77892,22216,150,11544,5481,10672,68.48804,62.77778,1897,20115,83.85568,91.42118,5024,76.54487,4593,102,1932,1356,2301,10450,15397,9.323584,2160,1094,14.89573,"507051185",63.046917,2744
12,1098,379,110,0,95.264114,78.01418,802,"Duntroon",1046,100.0,1526,0,428,141,1098,88.5514,93.454544,848,1526,100.0,97.26028,219,93.381386,213,0,12,257,31,428,1425,0.0,275,0,0.0,"801051125",94.57547,31
0,0,0,0,0,0.0,0.0,0,"Parkes (ACT) - North",0,0.0,0,0,0,0,0,0.0,0.0,0,0,0.0,0.0,0,0.0,0,0,0,0,0,0,0,0.0,0,0,0.0,"801051126",0.0,0
366,1368,1069,581,86,89.40058,79.48016,175,"Palmerston - North",1223,80.60109,2901,10,1447,731,1454,79.06805,69.411766,249,2720,88.46154,95.06173,729,84.26471,693,16,295,177,345,1352,2292,16.842106,255,95,11.627907,"701041041",70.28113,390
0,0,0,0,0,0.0,0.0,0,"Rockingham Lakes",0,0.0,0,0,0,0,0,0.0,0.0,0,0,0.0,0.0,0,0.0,0,0,0,0,0,0,0,0.0,0,0,0.0,"507051189",0.0,0
1525,3243,2162,793,1191,76.41073,64.68189,355,"Safety Bay - Shoalwater",2478,63.67213,9025,122,4591,1226,4434,65.77426,61.75373,617,6530,72.22222,80.89701,1204,71.05666,974,67,971,331,1027,3287,4640,5.1380367,536,1304,10.243493,"507051190",57.53647,1422
1616,4091,2832,1197,539,78.22048,64.49354,540,"Port Kennedy",3200,65.16089,9583,76,4953,1856,4630,64.203125,58.679447,972,8502,81.07932,84.56673,1581,70.94801,1337,31,1053,551,1247,4411,6032,5.7195573,939,542,14.100185,"507051187",55.555557,1538
1979,4359,2774,1022,1451,77.60954,65.30351,543,"Rockingham",3383,59.777664,11948,165,6138,1565,5810,64.1239,59.974426,861,8685,71.45127,82.360245,1610,70.89234,1326,100,1183,469,1349,4326,6157,5.518764,782,1812,11.371468,"507051188",63.0662,1888
542,1284,1002,425,144,81.54205,72.27891,155,"Charles",1047,75.27676,2943,44,1515,588,1428,73.13869,60.416668,236,2654,79.57198,82.20974,534,77.20422,439,24,408,145,409,1370,2049,16.551723,240,145,30.555555,"702011045",65.67796,514
436,1452,1087,557,77,91.873276,76.30137,182,"Durack - Marlow Lagoon",1334,81.651375,2994,27,1465,730,1529,78.65412,70.37037,254,2834,92.96703,94.48183,743,85.426956,702,22,356,152,423,1382,2421,26.506023,216,83,35.064934,"701041038",71.65354,455
673,1504,1403,654,172,82.84574,81.64794,148,"East Side",1246,80.68351,3559,54,1883,801,1676,82.14286,66.666664,270,3212,84.15301,84.9635,685,82.47198,582,50,543,156,462,1708,2649,28.571428,234,175,31.39535,"702011046",54.814816,549
316,1493,923,522,36,92.23041,75.0,135,"Newman",1377,79.11392,2803,28,1274,696,1529,73.89912,59.07173,200,2742,90.786514,95.51887,848,83.88038,810,11,250,140,404,1249,2300,44.0,237,25,77.77778,"510021268",67.5,445
358,1584,972,579,79,93.24495,77.40642,109,"Port Hedland",1477,74.02235,2984,32,1321,748,1663,76.17555,67.64706,158,2860,89.818184,96.11872,876,85.62937,842,13,265,115,494,1276,2449,28.88889,170,45,40.50633,"510021269",68.98734,550
2057,6132,4278,1961,525,82.55055,67.134544,809,"Singleton - Golden Bay - Secret Harbour",5062,72.63004,13461,92,6804,2921,6657,68.30592,61.011673,1419,12395,85.44211,90.47262,2666,75.35297,2412,39,1494,784,1749,6263,9340,7.2088723,1285,541,17.52381,"507051191",57.011982,2047
315,986,665,340,107,76.67343,73.59307,101,"Gray",756,66.666664,2163,19,1070,462,1093,69.63351,51.685394,193,1941,74.04372,85.480095,427,73.20969,365,23,210,92,271,955,1421,20.0,178,115,17.75701,"701041039",52.331608,366
851,1485,1151,365,659,82.55892,70.59961,131,"Denmark",1226,68.86016,4387,168,2243,517,2144,72.38994,50.0,263,3075,71.96602,83.9196,398,77.30081,334,89,586,111,593,1590,2377,13.629403,222,653,25.493172,"509011228",49.809887,824
351,907,606,252,192,96.03087,77.06422,87,"Gnowangerup",871,75.21368,1998,89,899,327,1099,80.2649,57.142857,118,1662,86.1678,90.51724,348,88.868835,315,46,264,44,380,755,1477,31.944445,77,144,46.354168,"509011229",73.72881,441
1623,3800,2502,1003,661,76.8421,64.253685,448,"Waikiki",2920,63.462723,9124,75,4663,1561,4461,63.924374,57.80822,799,7714,75.520836,84.43686,1465,70.28779,1237,47,1030,422,1160,3914,5422,6.2750335,730,749,11.346445,"507051192",56.070087,1536
1342,3338,2068,827,568,73.547035,61.441307,394,"Warnbro",2455,62.14605,7856,57,3950,1346,3906,62.064827,56.0559,752,6670,74.41332,80.711464,1265,67.8111,1021,46,834,361,983,3332,4523,7.4433656,644,618,10.035212,"507051193",52.393616,1321
1909,3644,2975,1082,1460,82.821075,73.10811,444,"Albany",3018,69.093765,11153,248,6049,1480,5104,72.898796,60.549133,760,7725,77.91486,84.16469,1263,77.579285,1063,155,1319,419,1263,4081,5993,7.876016,692,1968,16.986301,"509011225",58.42105,1621
538,1023,752,222,314,88.17204,71.6129,77,"Albany Region",902,72.49071,2589,121,1252,310,1337,73.509285,44.0,170,2046,78.22141,90.397354,302,80.84067,273,63,390,77,431,1023,1654,27.510918,175,229,38.53503,"509011226",45.294117,551
657,1334,1036,395,406,82.008995,74.24812,160,"Bayonet Head - Lower King",1094,70.77625,3577,51,1837,532,1740,72.9064,59.051723,278,2755,79.4958,88.937096,461,77.31397,410,39,465,137,473,1421,2130,9.375,232,416,12.561576,"509011227",57.553955,595
1317,2960,2245,853,741,81.689186,68.40417,408,"McKail - Willyung",2418,68.640854,7645,134,3944,1247,3701,69.89415,63.271606,637,6172,75.49612,85.99657,1164,75.55087,1001,78,904,410,875,3212,4663,10.655738,648,732,18.083672,"509011233",64.05023,1159
726,1475,979,293,474,77.22034,64.25439,131,"Plantagenet",1139,67.21763,3813,139,1864,456,1949,70.48236,54.58937,250,2864,69.547874,73.15011,473,73.952515,346,85,488,113,523,1389,2118,17.894737,207,475,29.324894,"509011234",52.4,752
294,839,557,270,81,71.87128,67.5,90,"Moulden",603,69.38776,1881,14,961,400,920,64.24452,41.040462,183,1706,74.48276,77.3224,366,67.99531,283,12,204,71,216,867,1160,12.765958,173,94,17.28395,"701041040",49.18033,290
0,0,0,0,0,0.0,0.0,0,"Stirling Range National Park",0,0.0,0,0,0,0,0,0.0,0.0,0,0,0.0,0.0,0,0.0,0,0,0,0,0,0,0,0.0,0,0,0.0,"509011235",0.0,0
1136,2378,1617,577,939,83.68377,69.43442,197,"Gingin - Dandaragan",1990,64.96479,6389,216,3072,831,3317,71.580345,56.50685,331,4637,71.20968,85.99752,807,77.78736,694,137,738,165,883,2259,3607,16.851168,292,813,23.003195,"509021239",59.516617,1240
753,2970,1863,1015,139,84.00674,68.35017,274,"South Hedland",2495,69.85392,5959,49,2850,1485,3109,68.16685,59.39394,459,5703,83.5084,88.32585,1559,76.415924,1377,28,526,294,795,2733,4358,23.931623,495,117,35.251797,"510021270",59.69499,952
707,6705,1799,1039,129,97.002235,75.289856,305,"Ashburton (WA)",6504,81.89533,9253,94,2419,1380,6834,76.55319,61.21673,404,9055,96.31356,97.23421,3941,91.6952,3832,20,579,161,2273,2350,8303,28.985508,263,69,72.86822,"510031271",75.49505,2360
189,601,365,163,107,72.379364,80.69307,76,"Reid",435,69.31217,1315,27,607,202,708,74.4898,62.626263,119,1091,59.74576,77.64227,246,73.327225,191,9,131,62,141,490,800,7.6923075,99,117,25.233644,"801051127",63.865547,236
0,0,0,0,0,0.0,0.0,0,"Russell",0,0.0,0,0,0,0,0,0.0,0.0,0,0,0.0,0.0,0,0.0,0,0,0,0,0,0,0,0.0,0,0,0.0,"801051128",0.0,0
774,1211,854,217,517,82.080925,63.081394,102,"Toodyay",994,61.627907,3417,108,1689,344,1728,66.71875,54.320988,189,2491,74.3338,82.200645,309,74.18707,254,72,477,88,530,1280,1848,17.603912,162,409,20.889748,"509021244",53.968254,713
509,977,674,222,402,89.45752,65.68047,79,"Brookton",874,65.61886,2689,127,1310,338,1379,70.42842,48.18182,141,1934,78.916824,81.5047,319,80.04137,260,65,334,53,408,957,1548,18.413597,110,353,31.59204,"509031246",56.02837,517
473,1233,856,395,225,69.91079,72.74401,136,"West Moonah",862,65.11628,2999,24,1541,543,1458,67.99047,51.028805,266,2492,68.54664,76.284584,506,68.94061,386,29,308,124,316,1259,1718,10.283688,243,282,10.666667,"601031021",51.12782,461
1438,3224,2543,1162,753,78.877174,77.260635,374,"Kingston - Huntingfield",2543,66.550766,8566,99,4589,1504,3977,71.45265,58.02269,664,6783,74.220726,86.59869,1373,74.981575,1189,66,957,358,881,3559,5086,6.407767,617,1030,13.14741,"601041022",56.325302,1187
792,1649,1145,395,399,84.05094,69.91151,155,"Chittering",1386,68.81313,4045,101,1997,565,2048,70.03058,50.719425,314,3284,81.36646,89.62264,530,77.07065,475,64,545,141,655,1635,2531,17.679558,278,362,25.313284,"509021236",49.363056,805
509,1192,705,265,364,79.27853,66.91919,106,"Cunderdin",945,64.63654,2979,97,1423,396,1556,66.824646,40.0,251,2247,75.26691,84.16887,379,73.431244,319,51,329,60,423,1055,1650,13.858696,150,368,26.648352,"509021237",42.231075,562
528,1136,780,304,378,91.10915,71.02804,93,"Dowerin",1035,66.47727,2939,126,1425,428,1514,73.03371,51.785713,140,2204,77.34242,88.50856,409,82.35027,362,67,351,58,454,1068,1815,18.767508,112,357,33.333332,"509021238",66.42857,587
1445,3346,2067,746,884,67.75254,65.726875,293,"Northam",2267,65.19031,8223,166,3993,1135,4230,66.93653,50.787403,607,6434,70.51282,61.273407,1335,67.36089,818,121,942,258,990,3088,4334,13.370166,508,905,18.77828,"509021243",48.27018,1404
795,1335,952,308,645,83.37079,71.296295,120,"York - Beverley",1113,62.012577,3948,155,1968,432,1980,70.154755,54.615383,200,2692,68.84817,84.09704,371,76.70876,312,80,493,71,526,1357,2065,13.093289,130,611,24.031008,"509021245",60.0,764
568,1231,904,330,363,81.153534,67.90124,133,"Narrogin",999,69.71831,3326,100,1732,486,1594,67.816956,43.369175,270,2564,79.88615,79.49309,434,74.21997,345,57,396,121,421,1333,1903,14.285714,279,399,27.54821,"509031249",49.25926,527
718,1344,1016,347,508,91.51786,74.30407,109,"Wagin",1230,71.30919,3596,158,1744,467,1852,75.99103,46.05263,172,2681,78.6014,87.74617,457,83.77471,401,87,512,70,562,1337,2246,21.375921,152,407,31.102362,"509031250",63.372093,715
1529,4251,3354,1760,424,80.12232,78.7472,342,"Broome",3406,76.586006,9349,126,4674,2235,4675,77.138916,59.246574,642,8599,78.08989,84.0558,2007,78.61379,1687,77,1171,346,1251,4348,6760,23.619633,584,326,29.716982,"510011262",53.271027,1602
770,2341,1114,529,227,51.21743,48.576675,148,"Derby - West Kimberley",1199,55.194805,5076,73,2508,1089,2568,47.811157,27.388535,496,4671,57.667103,49.722736,1082,49.518303,538,31,425,129,440,2330,2313,17.41573,471,178,32.15859,"510011263",29.838709,763
273,783,338,163,66,46.23244,39.853302,48,"Halls Creek",362,44.688644,1807,13,958,409,849,37.76536,22.535212,199,1678,57.264957,47.714287,350,41.716328,167,5,122,48,134,895,700,7.9365077,213,63,19.69697,"510011264",24.120604,234
794,2144,1573,745,220,77.75187,69.95305,229,"Kununurra",1667,73.04786,4785,78,2421,1065,2364,69.725174,48.61461,407,4400,77.97834,78.5872,906,73.63636,712,55,580,193,648,2256,3240,33.333332,397,165,35.454544,"510011265",56.265358,831
226,644,310,145,64,47.670807,50.17301,46,"Roebuck",307,50.44248,1453,16,745,289,708,45.722713,25.153374,165,1322,57.013577,46.12403,258,46.67171,119,10,114,41,126,678,617,14.925373,163,67,25.0,"510011266",27.878788,221
343,3371,743,403,97,90.68526,67.959526,189,"East Pilbara",3057,70.84548,4643,54,1175,593,3468,66.756516,45.19774,271,4484,89.645256,91.34662,2057,84.745766,1879,17,243,80,935,1113,3800,27.419355,177,62,55.670105,"510021267",69.7417,1043
1237,5273,3393,1915,175,88.1851,71.26907,517,"Karratha",4650,76.798706,10271,92,4823,2687,5448,72.19149,62.628864,837,9973,88.97387,92.256714,2867,80.64775,2645,42,950,486,1396,4700,8043,34.146343,776,123,52.57143,"510031272",61.76822,1569
454,2233,896,475,96,79.13121,65.51724,147,"Roebourne",1767,66.07929,3802,34,1473,725,2329,63.501064,46.551723,332,3644,83.695656,83.2618,1165,73.07903,970,13,300,108,616,1411,2663,20.967741,232,62,35.416668,"510031273",44.277107,736
1525,2870,2477,932,860,81.533104,79.45439,323,"Kingston Beach - Blackmans Bay",2340,71.7377,7999,137,4269,1173,3730,75.9816,65.65836,594,6130,77.87267,88.76518,988,78.58075,877,82,1094,369,1003,3260,4817,8.126859,562,1009,15.930233,"601041023",54.377106,1288
1041,2250,1790,762,507,83.111115,77.99386,212,"Margate - Snug",1870,72.622475,5672,84,2915,977,2757,75.052414,62.12534,383,4635,77.69003,92.154564,854,78.9644,787,44,756,228,787,2385,3660,8.301887,367,530,16.568047,"601041024",55.35248,1013
0,0,0,0,0,0.0,0.0,0,"Mount Wellington",0,0.0,0,0,0,0,0,0.0,0.0,0,0,0.0,0.0,0,0.0,0,0,0,0,0,0,0,0.0,0,0,0.0,"601041025",0.0,0
562,947,813,284,343,81.94298,84.52381,75,"Taroona - Bonnet Hill",776,71.53025,2764,61,1474,336,1290,75.91036,50.86705,174,2018,80.082985,87.285225,291,78.741325,254,39,402,88,386,1071,1589,9.67742,173,403,17.784256,"601041026",43.103447,482
870,2636,1958,899,519,74.35508,77.56687,284,"Hobart",1960,70.68965,6501,133,3346,1159,3155,72.277596,55.294117,579,5345,70.07126,78.43621,1215,73.302155,953,68,615,376,590,2709,3918,10.675039,680,637,25.626204,"601051027",49.050087,842
1160,2535,2206,946,545,82.01183,84.38894,239,"Lenah Valley - Mount Stuart",2079,75.344826,6486,103,3406,1121,3080,79.9855,64.15094,456,5293,78.72745,88.49902,1026,80.95598,908,80,874,306,829,2758,4285,12.345679,477,648,18.899082,"601051028",52.41228,1053
582,1544,1063,415,283,68.26425,72.934975,154,"Mount Nelson - Dynnyrne",1054,71.821304,3731,59,1904,569,1827,66.02484,40.087147,458,3154,79.30367,75.746925,569,67.12112,431,46,418,184,410,1610,2117,15.646258,459,294,20.848057,"601051029",33.624454,517
1468,3359,2523,970,879,86.21613,74.386505,448,"Esperance",2896,72.07085,8630,207,4392,1304,4238,74.227715,59.808613,703,6758,80.86545,88.78505,1177,80.18645,1045,120,1058,375,1196,3399,5419,12.084592,627,993,23.549488,"511011274",63.726883,1479
422,1141,692,290,266,90.096405,72.139305,86,"Esperance Region",1028,69.19431,2573,89,1166,402,1407,72.53669,44.615383,163,2095,84.36294,90.434784,460,82.100235,416,52,292,58,437,954,1720,24.528301,130,212,33.458645,"511011275",52.760735,518
487,1366,1025,471,266,72.694,75.48077,153,"South Launceston",993,72.07392,3522,40,1890,624,1632,71.728485,58.1761,312,2795,69.26503,80.82645,605,72.200356,489,18,351,185,311,1429,2018,3.9045553,318,461,15.037594,"602011047",49.03846,449
583,1436,1028,412,337,75.766014,71.90227,113,"Carnarvon",1088,73.413376,3452,88,1679,573,1773,73.37616,53.877552,218,2837,69.03409,78.015564,514,74.58583,401,56,428,132,486,1401,2116,20.143885,245,278,26.11276,"511021276",51.83486,704
468,1335,961,459,299,86.81648,75.49342,121,"Exmouth",1159,73.50427,3096,55,1462,608,1634,76.634766,69.10112,167,2589,79.09408,89.057236,594,81.884895,529,35,344,123,454,1254,2120,16.826923,178,208,18.39465,"511021277",72.45509,574
512,1266,1075,494,121,86.25592,76.1171,149,"Flynn (NT)",1092,79.88281,2931,43,1544,649,1387,77.44957,58.59031,240,2654,84.90991,89.86254,582,81.65034,523,39,409,133,377,1388,2167,25.0,227,156,35.53719,"702011047",62.083332,444
447,1093,830,305,153,86.276306,80.901855,159,"Virginia",943,82.102905,2377,40,1131,377,1246,82.58707,71.823204,212,2098,80.55556,89.655174,377,84.509056,338,28,367,130,406,1005,1773,22.222221,181,126,26.143791,"701031034",75.0,504
747,2329,1343,595,239,80.2061,64.04736,302,"Boulder",1868,70.95047,4837,68,2269,929,2568,65.036316,49.357327,464,4394,80.13544,80.490295,979,73.07692,788,26,530,192,710,2065,3211,12.745098,389,204,28.451883,"511031278",65.086205,886
1381,4602,2983,1439,479,85.289,71.13198,540,"Kalgoorlie",3925,73.352646,9674,112,4593,2023,5081,71.46622,61.298702,867,8776,84.85401,89.813484,2091,78.714676,1878,59,1013,472,1395,4174,6908,14.081145,770,419,23.382046,"511031279",62.283737,1644
269,855,565,267,108,75.90643,70.26316,85,"Ludmilla - The Narrows",649,69.14498,1862,21,899,380,963,72.15836,61.19403,167,1638,75.26132,81.546135,401,74.11478,327,30,186,82,216,783,1214,25.862068,134,116,19.444445,"701011006",50.898205,287
374,1624,555,250,125,75.24631,48.44961,98,"Leinster - Leonora",1222,58.28877,2930,47,1181,516,1749,50.546448,31.73077,235,2722,80.42328,75.54745,822,65.28288,621,21,218,66,456,1098,1777,25.301205,208,83,37.6,"511031283",41.70213,567
494,1443,884,378,179,81.63548,74.117645,118,"Weddell",1178,72.8745,2942,57,1320,510,1622,74.28571,59.677418,211,2633,74.67949,88.322365,608,78.31371,537,35,360,111,466,1190,2062,26.923077,186,130,31.843575,"701031035",55.92417,624
529,1368,908,429,333,65.789474,65.89862,140,"Mornington - Warrane",900,54.63138,3609,30,1908,651,1701,62.14921,58.362988,285,2829,60.03976,73.793106,580,63.909508,428,26,289,164,302,1461,1808,5.816555,281,447,9.009009,"601021009",49.122807,503
609,1359,1083,455,356,80.868286,77.51278,183,"Summerhill - Prospect",1099,71.92118,3621,51,1906,587,1715,74.792816,69.44444,307,2807,78.26923,86.090225,532,77.73424,458,15,438,175,407,1448,2182,3.275109,252,458,14.325843,"602011048",59.60912,520
283,1163,438,212,183,39.89682,59.71831,65,"Risdon Vale",464,55.830387,2355,12,1009,355,1346,56.081947,43.356644,224,1944,48.476456,36.6782,578,46.399178,212,6,158,62,175,781,902,2.631579,143,228,6.557377,"601021010",29.017857,361
652,1663,1219,592,296,64.94287,64.699455,169,"Rokeby",1080,57.51534,4300,31,2341,915,1959,61.19478,50.588234,369,3655,55.97826,76.95418,742,62.900135,571,37,375,215,309,1992,2299,10.601719,425,349,10.472973,"601021011",45.799458,552
699,1329,1030,375,314,81.038376,81.16883,103,"South Arm",1077,72.103004,3252,51,1609,462,1643,76.40949,71.12299,193,2677,76.08371,88.65096,467,78.70751,414,18,504,133,509,1348,2107,6.8965516,187,261,16.242039,"601021012",53.367874,669
546,1230,956,389,282,83.333336,77.0297,169,"Austins Ferry - Granton",1025,72.16117,3079,45,1567,505,1512,75.692795,66.98113,262,2493,81.048386,86.65254,472,79.462494,409,31,394,142,402,1263,1981,10.197369,212,304,15.957447,"601031013",64.503815,496
700,1619,1120,457,384,72.143295,69.664635,163,"Berriedale - Chigwell",1168,65.0,4100,44,2097,656,2003,66.90562,57.54717,333,3293,68.7218,81.159424,621,69.48071,504,25,455,183,457,1674,2288,5.9101653,318,423,11.458333,"601031014",48.948948,665
833,1870,1594,697,338,80.53476,80.76477,184,"West Hobart",1506,75.27011,4656,70,2448,863,2208,79.06746,65.9375,336,3886,78.0293,85.05747,783,79.773544,666,59,627,211,586,2016,3100,13.657408,320,432,20.71006,"601051033",54.761906,751
1133,2323,1578,614,553,72.14809,74.87805,201,"Dodges Ferry - Lewisham",1676,63.98941,5689,77,2813,820,2876,68.40052,53.107346,396,4630,67.315834,80.8311,746,70.28078,603,51,725,188,795,2307,3254,10.079051,354,506,13.92405,"601061034",50.757576,1181
1185,2363,1908,755,769,82.52222,78.89237,262,"Sorell - Richmond",1950,67.59494,6574,122,3442,957,3132,73.38461,61.135372,443,4963,76.318405,87.3224,915,77.73524,799,72,801,280,767,2600,3858,8.551069,458,842,15.864759,"601061035",59.142212,1005
381,1007,641,235,170,59.38431,65.82633,123,"Invermay",598,63.254593,2374,25,1197,357,1177,63.09055,51.43885,287,2023,58.966564,65.473145,391,61.245674,256,22,241,143,194,1016,1239,12.154696,278,181,14.705882,"602011036",42.857143,329
425,1054,690,300,216,71.63188,68.027214,136,"Waverley - St Leonards",755,61.17647,2609,23,1339,441,1270,65.4649,57.446808,258,2108,71.256035,78.795815,382,68.548386,301,22,260,108,295,1054,1445,7.7192984,188,285,10.648149,"602011050",52.713177,414
500,1169,878,384,334,76.390076,72.58979,124,"Kings Meadows - Punchbowl",893,66.2,3227,36,1724,529,1503,70.18385,60.81081,239,2420,71.59091,85.30612,490,73.181816,418,28,331,135,315,1251,1771,5.9196615,222,473,10.778443,"602011037",51.882847,440
715,1603,1199,458,337,78.041176,78.69416,172,"Launceston",1251,70.48951,3952,83,2012,582,1940,73.83005,56.574924,344,3227,79.653,78.56,625,75.921906,491,52,504,185,505,1624,2450,13.402061,327,388,24.62908,"602011038",50.0,634
537,1157,914,350,358,83.83751,80.831406,162,"Legana",970,72.6257,3168,54,1653,433,1515,75.474815,59.336098,263,2368,79.64427,90.46392,388,79.560814,351,31,390,143,403,1211,1884,7.0135746,241,442,15.083798,"602011039",61.59696,506
592,1168,768,260,388,77.91096,68.783066,101,"Westbury",910,62.837837,3100,85,1544,378,1556,66.84073,51.39665,218,2317,74.50658,79.23977,342,72.421234,271,44,372,92,453,1149,1678,11.13924,179,395,21.907217,"602021057",46.330276,608
636,1242,848,296,327,79.62963,74.93671,97,"Dilston - Lilydale",989,68.396225,3032,79,1463,395,1569,71.56118,49.35065,210,2427,74.31193,86.507935,378,75.690155,327,41,435,76,486,1185,1837,14.748201,154,278,24.159021,"602031058",46.190475,654
938,1862,1009,353,682,65.30612,54.475307,140,"George Town",1216,52.132195,5104,75,2560,648,2544,52.771965,34.969326,344,3774,61.491318,74.02597,539,58.956017,399,53,489,114,602,1912,2225,8.179012,326,648,10.997067,"602031059",40.697674,979
582,1076,752,241,430,81.784386,63.089005,129,"Longford",880,62.542953,3141,67,1635,382,1506,64.38356,49.019608,218,2244,77.864075,82.507286,343,72.72727,283,47,364,100,401,1168,1632,10.06424,204,467,15.581395,"602031060",59.174313,515
490,1030,663,237,343,77.37864,64.9315,92,"Northern Midlands",797,62.040817,2718,67,1345,365,1373,65.51383,47.770702,175,2042,67.391304,85.10029,349,71.49853,297,47,304,75,341,1012,1460,14.114114,157,333,19.533527,"602031061",52.57143,506
734,1463,1141,404,450,83.3903,76.370514,157,"Perth - Evandale",1220,70.70845,3879,77,1966,529,1913,75.31353,66.269844,277,2978,77.97784,91.163795,464,79.281395,423,51,519,167,563,1515,2361,11.308204,252,451,17.11111,"602031062",56.6787,722
975,1590,967,307,836,60.25157,64.36059,106,"St Helens - Scamander",958,52.71795,4795,73,2369,477,2426,58.85575,47.12042,218,3233,50.614754,71.969696,396,59.54222,285,56,514,90,494,1643,1925,7.7134986,191,726,8.732058,"602031064",48.62385,976
141,254,177,53,120,93.30708,75.71429,18,"Flinders and Cape Barren Islands",237,64.53901,701,39,327,70,374,76.623375,80.0,28,485,76.92308,85.71429,70,85.360825,60,17,91,16,120,231,414,17.708334,20,96,32.5,"602031099",64.28571,156
918,1816,1149,376,698,77.588104,61.53846,182,"Scottsdale - Bridport",1409,61.220043,5068,110,2554,611,2514,63.37562,49.64789,328,3629,69.052864,84.48276,580,70.48774,490,70,562,141,627,1813,2558,9.446693,284,741,15.759313,"602031100",55.487804,908
280,609,323,115,256,77.504105,63.186813,43,"Central Highlands",472,51.42857,1584,56,719,182,865,60.148975,46.666668,77,1146,61.80758,85.18519,189,69.37173,161,29,144,35,212,537,795,15.934066,75,182,21.875,"603011065",55.844154,343
467,988,561,206,246,67.408905,66.666664,63,"Derwent Valley",666,57.60171,2326,44,1092,309,1234,61.58068,47.407406,165,1899,64.70588,73.16294,313,64.61295,229,22,269,64,330,911,1227,12.154696,135,181,17.886179,"603011066",38.18182,510
873,1848,1180,416,504,76.94805,70.03367,183,"Southern Midlands",1422,62.31386,4557,112,2205,594,2352,67.007385,56.802723,338,3609,69.871796,82.40418,574,72.097534,473,53,544,167,654,1761,2602,11.936937,294,444,22.222221,"603011067",54.142014,936
0,3,3,0,0,100.0,0.0,0,"Wilderness - East",3,0.0,6,0,3,0,3,100.0,100.0,0,6,0.0,100.0,3,100.0,3,0,0,3,0,3,6,0.0,3,0,0.0,"603011068",0.0,0
349,1257,596,250,201,57.438347,55.06608,147,"Mowbray",722,52.72206,2850,16,1392,454,1458,52.696728,44.817074,399,2388,63.387978,66.46342,492,55.19263,327,15,184,147,232,1131,1318,5.7471266,328,261,7.960199,"602011040",36.842106,366
988,2743,1567,601,567,59.71564,56.273407,307,"Newnham - Mayfield",1638,55.97166,6843,55,3533,1068,3310,55.19549,47.381866,809,5582,65.38461,66.47619,1050,57.416695,698,42,553,371,578,2839,3205,6.051873,783,694,9.700176,"602011041",37.948086,884
620,1351,1125,453,427,76.38786,76.006714,143,"Newstead",1032,70.32258,3930,58,2152,596,1778,72.81554,59.574467,324,2896,77.62907,84.32539,504,74.48204,425,40,436,196,406,1545,2157,6.589786,329,607,13.583138,"602011042",44.135803,523
772,1546,1049,352,379,80.27167,72.877846,169,"Burnie - Ulverstone Region",1241,64.378235,3758,102,1833,483,1925,68.60693,54.379562,279,3075,73.173805,82.24101,473,74.47154,389,51,497,149,581,1529,2290,16.776316,274,304,26.91293,"604011076",60.573475,794
500,1086,717,266,260,66.574585,62.295082,119,"Burnie - Wivenhoe",723,58.8,2816,36,1470,427,1346,61.545063,55.882355,231,2251,61.18421,72.431076,399,63.97157,289,24,294,133,279,1165,1440,7.8688526,238,305,13.846154,"604011077",51.515152,456
510,937,869,327,437,86.446106,82.57576,115,"Norwood (Tas.)",810,74.31373,3032,63,1658,396,1374,79.87132,65.93407,196,2025,81.92771,89.57055,326,82.91358,292,43,379,120,340,1088,1679,7.5438595,182,570,14.416476,"602011043",58.67347,415
823,1726,1237,464,518,69.00348,66.38055,200,"Parklands - Camdale",1191,64.88457,4825,48,2581,699,2244,63.795773,50.35971,440,3665,73.30567,73.35702,563,66.24829,413,29,534,210,530,1939,2428,4.517134,417,642,9.266409,"604011078",45.454544,723
741,1374,1039,385,474,80.4949,73.896355,163,"Penguin - Sulphur Creek",1106,63.967613,3861,68,2013,521,1848,68.0865,59.090908,268,2900,72.91022,87.82609,460,73.965515,404,24,474,156,471,1526,2145,4.9281316,264,487,14.345991,"604011079",60.820896,646
455,1015,730,283,246,75.17242,69.87654,143,"Romaine - Havenview",763,62.637363,2626,23,1365,405,1261,67.281105,63.11111,231,2100,72.61307,79.79275,386,71.09524,308,20,285,142,289,1085,1493,7.142857,225,280,9.349593,"604011080",61.904762,398
547,1075,747,274,367,74.325584,68.1592,122,"Somerset",799,61.06033,3000,37,1558,402,1442,66.4,64.77273,205,2200,67.94355,81.016045,374,70.27273,303,25,334,114,337,1125,1546,5.773672,176,433,10.081744,"604011081",59.512196,496
961,1845,1313,497,689,72.62872,72.55474,195,"Ulverstone",1340,59.72945,5419,62,2885,685,2534,65.68284,57.507084,366,3844,68.89401,79.37807,611,69.01665,485,39,574,203,598,1999,2653,4.401806,353,886,8.9985485,"604011082",53.27869,868
596,1095,764,243,456,71.05023,63.779526,117,"West Ulverstone",778,62.919464,3275,43,1724,381,1551,64.25568,55.660378,225,2284,66.856064,77.48538,342,67.51314,265,28,375,118,353,1189,1542,5.233645,212,535,9.429825,"604011083",52.0,528
884,1606,1097,387,643,71.73101,65.70458,170,"Wynyard",1152,59.049774,4774,56,2525,589,2249,62.11778,51.877132,302,3372,65.044815,79.923515,523,66.69632,418,36,522,152,508,1766,2249,4.743083,293,759,8.709176,"604011084",56.29139,781
1775,3656,2618,1006,1210,69.88512,65.92398,348,"Devonport",2555,60.507042,10663,126,5797,1526,4866,63.698296,53.646477,740,7766,65.844154,77.5436,1376,66.61087,1067,104,1074,434,1014,4110,5173,6.1647897,809,1687,10.413223,"604021085",47.027027,1540
656,1218,746,261,454,66.502464,54.488518,118,"East Devonport",810,53.353657,3581,62,1909,479,1672,53.7464,43.873516,242,2606,60.962566,69.39759,415,59.708366,288,24,350,111,342,1388,1556,4.606526,253,521,13.656387,"604021086",48.76033,561
574,1225,903,371,416,78.44898,72.46094,131,"Latrobe",961,62.71777,3449,54,1808,512,1641,70.0,64.70588,203,2515,68.40149,84.29752,484,74.11531,408,40,360,132,368,1290,1864,7.7220078,204,518,12.980769,"604021087",64.53202,538
908,1837,1472,552,519,81.98149,77.746475,242,"Prospect Vale - Blackstone",1506,71.69604,5076,57,2720,710,2356,74.26842,62.087914,392,3819,80.222496,87.73585,636,77.97853,558,43,651,226,649,1982,2978,5.826558,364,738,10.982659,"602011044",61.734695,809
493,929,729,262,305,82.66954,82.13166,108,"Turners Beach - Forth",768,70.588234,2462,58,1228,319,1234,77.71855,68.25397,187,1867,77.41228,87.062935,286,80.18211,249,33,348,86,353,938,1497,11.379311,126,290,19.016394,"604021092",57.75401,456
221,474,355,136,162,92.616035,81.92771,49,"King Island",439,76.47059,1210,45,574,166,636,83.72642,67.567566,70,898,83.91304,87.35632,174,88.41871,152,25,169,25,193,424,794,16.666666,37,150,27.777779,"604031093",70.0,230
527,1236,838,313,288,84.30421,76.528114,155,"North West",1042,69.449715,2904,83,1380,409,1524,73.70273,58.208954,244,2373,75.08533,89.655174,406,79.22461,364,42,366,117,440,1137,1880,17.28395,201,243,28.819445,"604031094",63.52459,586
505,1128,803,292,317,82.0922,72.817955,165,"Smithton",926,69.50495,2930,53,1485,401,1445,71.25111,56.561085,251,2255,75.05331,87.254906,408,76.67406,356,35,351,125,352,1127,1729,9.776536,221,358,16.719242,"604031095",65.73705,469
564,1128,711,214,306,74.46809,63.126842,101,"Waratah",840,66.31206,2773,66,1339,339,1434,65.955475,50.857143,196,2206,67.892975,79.94012,334,70.30825,267,34,374,89,406,1078,1551,13.02682,175,261,21.568628,"604031096",51.530613,598
575,1272,693,271,352,64.54402,58.913044,96,"West Coast (Tas.)",821,52.347828,3119,35,1495,460,1624,57.36755,51.445087,180,2480,58.195488,70.96019,427,61.048386,303,32,301,89,387,1208,1514,11.149826,173,287,9.943182,"604031097",53.333332,665
0,0,0,0,0,0.0,0.0,0,"Wilderness - West",0,0.0,0,0,0,0,0,0.0,0.0,0,0,0.0,0.0,0,0.0,0,0,0,0,0,0,0,0.0,0,0,0.0,"604031098",0.0,0
454,967,537,196,242,54.395035,49.49495,103,"Ravenswood",526,49.779736,2598,18,1389,396,1209,48.907104,37.903225,255,2065,52.61708,61.31805,349,51.476997,214,21,226,94,191,1098,1063,7.216495,248,291,7.4380164,"602011045",40.39216,363
572,1256,1056,420,269,81.84714,77.20588,152,"West Launceston",1028,75.17483,3204,49,1679,544,1525,77.76141,69.421486,263,2614,82.03125,84.61539,481,79.72456,407,38,430,168,420,1358,2084,11.838006,242,321,18.215614,"602011051",57.794678,512
306,1036,847,441,54,85.52123,80.917435,115,"Bakewell",886,83.333336,2206,14,1116,545,1090,80.74357,72.72727,190,2085,86.55738,91.12754,541,83.11751,493,7,255,144,264,1049,1733,10.447762,198,67,25.925926,"701041036",60.526318,305
597,1304,1047,417,399,85.04601,79.580154,177,"Youngtown - Relbia",1109,74.03685,3585,60,1882,524,1703,76.75953,62.55144,283,2668,80.36364,91.29512,471,80.80959,430,36,442,152,442,1364,2156,6.949807,243,518,15.037594,"602011052",62.54417,550
612,981,604,161,489,66.56473,57.91367,58,"Beauty Point - Beaconsfield",653,54.901962,2961,58,1491,278,1470,58.188824,48.648647,142,2019,56.71378,79.12088,273,62.258545,216,35,336,72,321,1038,1257,7.7262692,148,453,11.860941,"602021053",40.84507,566
804,1528,1035,353,606,78.3377,65.49165,170,"Deloraine",1197,59.95025,4367,112,2233,539,2134,64.647095,49.612404,296,3129,68.725365,83.22717,471,71.332695,392,72,482,128,523,1601,2232,11.392406,258,632,18.481848,"602021054",57.432434,761
907,1567,1203,382,589,77.21761,74.17476,116,"Grindelwald - Lanena",1210,68.02646,4429,98,2273,515,2156,70.640045,49.46619,264,3270,71.28263,87.20379,422,73.792046,368,65,617,139,628,1703,2413,11.403509,281,570,16.63837,"602021055",43.939392,881
468,2603,1614,975,156,93.008064,78.565674,259,"Darwin City",2421,73.290596,4910,72,2151,1241,2759,79.54658,80.9375,299,4632,85.84656,93.08785,1548,87.1114,1441,37,343,259,649,2029,4035,30.32787,320,122,46.153847,"701011002",86.62207,756
0,5,0,0,0,100.0,0.0,0,"East Point",5,0.0,5,0,0,0,5,0.0,0.0,0,5,100.0,0.0,0,100.0,0,0,0,0,5,0,5,0.0,0,0,0.0,"701011003",0.0,5
276,939,660,324,64,85.94249,73.63636,141,"Driver",807,77.89855,1969,24,966,440,1003,73.00885,59.574467,206,1843,83.6858,90.79602,402,79.59848,365,9,215,112,277,904,1467,14.516129,188,62,37.5,"701041037",68.4466,331
397,1038,892,444,232,91.04046,83.77358,80,"Fannie Bay - The Gardens",945,82.36776,2571,61,1301,530,1270,84.62998,63.779526,135,2092,84.74178,92.872116,477,87.81071,443,40,327,81,361,1054,1837,16.194332,127,247,26.293104,"701011004",59.25926,426
370,1336,944,495,163,94.461075,79.2,154,"Larrakeyah",1262,76.48649,2765,64,1266,625,1499,81.51986,78.52761,192,2494,87.63797,93.632416,691,88.452286,647,38,283,128,397,1158,2206,35.185184,163,108,39.263805,"701011005",80.208336,453
395,1482,1205,673,127,91.63293,85.51461,166,"Stuart Park",1358,85.56962,3109,44,1500,787,1609,86.25626,77.209305,211,2879,83.48018,94.12485,817,89.023964,769,28,338,166,379,1397,2563,27.184465,215,103,34.645668,"701011008",78.67299,454
301,1123,784,399,82,93.76669,86.17711,156,"Woolner - Bayview - Winnellie",1053,84.38538,2169,33,964,463,1205,86.91796,77.53623,209,2025,90.36827,97.14795,561,90.71605,545,24,254,107,319,902,1837,38.70968,138,62,40.243904,"701011009",74.64115,353
0,0,0,0,0,0.0,0.0,0,"Charles Darwin",0,0.0,0,0,0,0,0,0.0,0.0,0,0,0.0,0.0,0,0.0,0,0,0,0,0,0,0,0.0,0,0,0.0,"701021015",0.0,0
307,956,752,419,142,84.62343,80.57692,88,"Coconut Grove",809,71.3355,2218,25,1120,520,1098,77.04918,62.416107,125,1932,73.548386,89.827255,521,80.797104,468,21,219,93,228,976,1561,14.583333,149,144,17.605635,"701021016",70.4,310
229,537,438,198,94,82.681564,80.81633,53,"Jingili",444,79.0393,1275,20,644,245,631,78.635544,55.421688,94,1094,81.95122,85.29412,238,80.621574,203,13,181,46,168,557,882,14.942529,83,87,21.276596,"701021018",56.38298,205
561,1481,1104,513,147,80.21607,73.706894,177,"Karama",1188,73.79679,3325,39,1697,696,1628,71.875,54.121864,328,3017,80.71161,87.39903,619,75.969505,541,26,414,151,431,1536,2292,16.149069,279,161,26.530613,"701021019",53.963413,534
617,1500,1204,547,223,87.13333,83.1307,178,"Leanyer",1307,77.471634,3429,63,1706,658,1723,80.42752,64.86487,293,2997,86.111115,90.3328,631,83.78378,570,35,478,144,496,1497,2511,16.746412,222,209,28.251122,"701021020",60.750854,576
591,1438,1067,443,220,82.823364,73.9566,122,"Malak - Marrara",1191,75.80373,3283,63,1625,599,1658,74.51117,54.95868,239,2870,79.10448,88.75839,596,78.67596,529,43,448,133,477,1432,2258,22.279793,242,193,28.636364,"701021022",51.046024,603
284,823,640,337,106,83.47509,80.2381,76,"Millner",687,75.0,1875,16,946,420,929,77.294685,61.29032,117,1651,77.85714,88.49765,426,80.37553,377,14,213,76,218,828,1327,11.864407,124,118,15.094339,"701021023",64.95727,280
420,1245,1031,534,173,88.6747,80.30075,120,"Nightcliff",1104,81.90476,2848,57,1430,665,1418,80.926216,64.021164,181,2519,82.06388,90.25875,657,84.75585,593,32,344,121,334,1274,2135,20.512821,189,156,32.947975,"701021025",66.29834,407
377,1031,880,457,128,86.80892,80.45775,88,"Rapid Creek",895,79.31035,2354,40,1195,568,1159,80.73395,65.51724,148,2121,85.301834,88.047806,502,83.68694,442,29,299,95,325,1090,1775,27.619047,145,105,31.25,"701021026",59.45946,381
261,710,592,309,178,80.42254,80.25974,47,"Tiwi",571,76.62835,1842,30,954,385,888,78.82823,58.095238,106,1461,75.30864,86.14958,361,79.60301,311,22,200,61,183,751,1163,10.837439,105,203,16.853933,"701021027",44.339622,243
230,698,470,231,92,81.80516,77.25752,77,"Wagaman",571,70.434784,1517,22,727,299,790,73.55243,59.090908,134,1337,80.25751,86.10272,331,77.860886,285,12,162,65,187,639,1041,13.636364,110,88,23.913044,"701021028",57.46269,233
244,588,448,199,101,80.78231,82.57262,63,"Wanguri",475,75.81967,1372,19,683,241,689,75.29412,50.0,119,1183,79.66102,87.982834,233,78.02198,205,9,185,55,188,595,923,10.227273,110,88,18.811882,"701021029",52.941177,236
131,1039,794,507,15,91.81905,81.9063,196,"Palmerston - South",954,74.0458,2058,6,1004,619,1054,80.20202,77.916664,242,2029,86.131386,96.06061,660,86.15081,634,3,97,187,118,990,1748,21.428572,240,14,40.0,"701041042",80.99174,137
439,2135,1542,918,84,90.07026,74.69488,325,"Rosebery - Bellamack",1923,76.53758,4393,25,2174,1229,2219,74.60087,69.42356,436,4202,87.89809,94.38111,1228,82.46073,1159,11,336,277,414,2067,3465,10.280374,399,107,29.761906,"701041043",74.54128,471
345,1009,758,371,84,82.06145,76.49484,122,"Woodroffe",828,72.753624,2209,17,1116,485,1093,73.23672,58.536587,216,2044,81.818184,90.70796,452,77.59296,410,16,251,120,279,1035,1586,19.753086,205,81,20.238094,"701041044",56.48148,341
590,1466,1269,583,119,86.42565,80.747925,156,"Larapinta",1267,84.745766,3268,39,1683,722,1585,82.61719,65.17857,281,3002,88.7522,92.045456,616,84.47701,567,40,500,146,505,1536,2536,27.210884,224,147,32.77311,"702011048",55.516014,569
436,1176,1047,534,116,93.36735,84.7619,120,"Mount Johns",1098,84.86239,2603,55,1311,630,1292,86.743996,74.46809,176,2383,93.42105,91.36029,544,90.01259,497,38,370,105,426,1207,2145,36.53846,141,104,47.41379,"702011049",68.181816,456
974,2327,1722,751,498,81.13451,81.45336,291,"Kaleen",1888,67.4538,5695,91,2870,922,2825,73.77892,57.762558,501,4661,75.480225,89.0542,941,77.45119,838,61,657,253,668,2334,3610,11.380597,438,536,18.273092,"801011016",58.08383,885
196,810,515,274,42,75.06173,73.066666,117,"Petermann - Simpson",608,59.69388,1654,20,802,375,852,68.94244,63.636364,185,1557,75.89286,75.06235,401,72.125885,301,12,117,112,170,747,1123,21.818182,176,55,47.61905,"702011050",63.243244,224
353,672,528,179,162,80.059525,70.75099,62,"Ross",538,72.804535,1731,43,897,253,834,74.366196,59.615383,102,1382,79.70588,70.434784,230,77.13459,162,30,257,62,271,710,1066,16.04278,104,187,26.54321,"702011051",60.784313,340
216,569,198,88,39,32.688927,28.75817,18,"Yuendumu - Anmatjere",186,41.203705,1345,11,737,306,608,28.947369,10.493827,140,1253,43.373493,32.319393,263,30.646448,85,4,89,17,72,684,384,7.5471697,162,53,28.205128,"702011054",12.857142,166
333,1435,325,151,80,23.623693,31.26294,54,"Sandover - Plenty",339,37.237236,2697,18,1182,483,1515,30.20446,11.923077,360,2511,34.756096,20.481928,747,26.443647,153,19,124,31,114,1076,664,17.924528,260,106,22.5,"702011052",15.0,328
304,904,740,386,59,91.37168,85.20972,90,"Nhulunbuy",826,87.5,1856,32,893,453,963,86.247086,72.27723,128,1762,93.73219,88.23529,425,88.876274,375,15,266,73,329,858,1566,42.857143,101,35,54.23729,"702041064",70.3125,351
225,684,250,117,59,41.959064,40.766552,41,"Elsey",287,42.22222,1457,18,714,287,743,37.821484,17.449665,172,1345,50.490196,40.584415,308,39.92565,125,12,95,26,103,661,537,22.64151,149,53,30.508474,"702051065",23.83721,204
332,1257,410,184,85,36.913284,34.200745,58,"Gulf",464,46.385544,2594,16,1252,538,1342,34.74576,18.709677,341,2437,46.920822,40.0,575,35.863766,230,14,154,58,160,1180,874,19.444445,310,72,18.82353,"702051066",17.008799,341
925,2699,1929,926,355,82.32679,74.55717,321,"Katherine",2222,73.297295,5969,129,2915,1242,3054,73.068184,53.488373,522,5339,77.64103,84.4426,1202,77.74864,1015,72,678,253,757,2640,4151,26.181818,473,275,36.338028,"702051067",61.49425,975
212,645,278,124,49,48.372093,44.128113,64,"Victoria River",312,42.92453,1421,6,727,281,694,40.882355,29.946524,189,1325,57.86517,50.0,278,44.5283,139,7,91,56,103,680,590,14.893617,187,47,12.244898,"702051068",33.862434,178
247,716,288,141,42,38.268158,34.140434,30,"Tanami",274,42.914978,1668,16,910,413,758,34.244946,16.022099,188,1557,48.79227,39.56386,321,36.095055,127,12,106,29,101,841,562,17.391304,181,69,38.095238,"702011053",15.957447,207
322,684,566,224,207,85.23392,80.57554,83,"Aranda",583,77.01863,1848,37,957,278,891,77.74725,50.78125,151,1412,84.19244,90.08264,242,81.37394,218,29,248,65,245,728,1149,12.663755,128,229,17.874395,"801011001",54.96689,291
197,758,258,133,56,44.98681,38.43931,98,"Barkly",341,37.563454,1606,9,792,346,814,35.054348,21.243523,241,1494,44.808743,45.508984,334,40.093708,152,10,74,41,82,736,599,17.857143,193,56,16.071428,"702021055",40.663902,183
335,948,553,231,120,62.97468,58.92857,82,"Tennant Creek",597,66.56716,2072,35,1004,392,1068,60.76923,38.251366,187,1858,64.187325,62.060303,398,61.89451,247,29,223,70,233,910,1150,30.851065,183,94,29.166666,"702021056",43.850266,363
563,1387,804,349,289,70.511894,70.64777,87,"Alligator",978,63.23268,3086,47,1410,494,1676,65.57912,38.46154,189,2613,66.666664,75.7515,499,68.19747,378,34,356,65,466,1226,1782,18.47826,169,184,16.262976,"702031057",46.031746,699
162,535,219,89,50,56.26168,41.981133,45,"Daly",301,56.790123,1144,17,559,212,585,43.280632,18.181818,140,1041,61.49425,59.728508,221,49.95197,132,14,92,24,107,506,520,26.415094,132,53,34.0,"702031058",32.142857,174
169,649,179,102,17,21.879814,29.05983,15,"Thamarrurr",142,36.094673,1427,0,761,351,666,24.42019,5.633803,185,1382,34.02778,24.375,320,23.227207,78,4,61,12,49,733,321,14.285714,213,28,0.0,"702031059",8.1081085,144
277,818,269,135,48,31.784842,36.0,26,"Tiwi Islands",260,37.184116,1748,4,882,375,866,32.448734,12.99435,194,1647,38.247013,35.924934,373,32.119003,134,8,103,23,96,829,529,15.094339,177,53,8.333333,"702031060",13.402061,251
363,1380,387,182,61,30.289856,27.617603,51,"West Arnhem",418,38.01653,2926,21,1485,659,1441,27.044025,13.691932,380,2811,36.857143,33.384617,650,28.637495,217,11,138,56,129,1431,805,20.37037,409,54,34.42623,"702031061",13.421053,350
185,754,314,177,18,55.437664,46.701847,25,"Anindilyakwa",418,55.675674,1528,11,756,379,772,43.25069,14.197531,166,1480,71.09005,61.53846,377,49.45946,232,11,103,23,150,726,732,36.666668,162,30,61.11111,"702041062",15.060241,211
615,2256,626,308,105,27.570923,27.329193,67,"East Arnhem",622,40.650406,4841,23,2480,1127,2361,26.203432,8.191654,660,4645,41.272728,29.158699,1046,26.8676,305,15,250,53,227,2389,1248,16.483517,647,91,21.904762,"702041063",10.151515,550
347,2532,1700,1075,197,74.56556,77.28253,339,"Belconnen",1888,65.706055,5510,25,2781,1391,2729,68.16359,49.470898,667,5026,73.68421,83.77104,1485,71.38878,1244,23,228,374,280,2494,3588,8.013937,756,287,12.690355,"801011002",50.82459,380
451,2694,1888,966,239,72.71715,80.23256,476,"Bruce",1959,70.731705,5858,40,2925,1204,2933,71.16472,57.31463,959,5347,79.5045,84.43067,1291,71.946884,1090,31,319,572,353,2653,3847,11.397058,998,272,16.736403,"801011003",49.635036,444
325,936,670,347,141,80.23505,73.987206,126,"Charnwood",751,64.30769,2203,25,1126,469,1077,70.37815,62.02532,194,1888,71.17438,86.7679,461,75.26483,400,16,209,98,200,952,1421,9.195402,158,174,17.730497,"801011004",64.948456,281
371,813,720,339,232,82.41083,83.497536,76,"Cook",670,77.35849,2220,31,1175,406,1045,80.35714,57.983192,144,1709,76.234566,91.5942,345,81.334114,316,25,287,69,247,896,1390,8.960573,119,279,13.362069,"801011005",52.77778,324
817,2233,1919,1001,228,85.75907,83.76569,288,"Dunlop",1915,76.25459,5161,35,2700,1195,2461,79.26476,64.792175,447,4654,83.94062,92.82297,1045,82.380745,970,30,623,265,622,2421,3834,10.752688,409,279,15.350877,"801011006",64.42953,741
674,1540,1153,501,271,77.72727,77.79503,208,"Florey",1197,66.91395,3730,37,1919,644,1811,72.01749,60.424026,350,3141,74.12354,85.95601,591,74.81694,508,30,451,171,444,1601,2350,9.433962,283,318,13.653136,"801011008",59.42857,599
632,1648,1328,612,304,84.223305,83.60656,195,"Evatt",1388,70.41139,3961,54,2009,732,1952,79.094696,68.25397,326,3327,78.9644,92.47159,704,81.63511,651,56,445,215,488,1679,2716,16.969696,315,330,17.763159,"801011007",59.815952,618
351,890,659,273,283,83.03371,78.223495,118,"Hawker",739,73.78918,2317,51,1144,349,1173,77.89598,58.90411,198,1736,78.80597,85.71429,357,80.52995,306,41,259,86,264,846,1398,13.758389,146,298,18.021202,"801011013",59.59596,335
421,1021,830,371,240,84.03526,83.18385,112,"Flynn (ACT)",858,70.54632,2561,53,1300,446,1261,78.89734,70.27027,193,2073,77.18833,89.135254,451,81.42788,402,32,297,130,291,1052,1688,12.903226,185,248,22.083334,"801011009",58.03109,377
287,593,498,204,158,82.12479,85.0,53,"Fraser",487,69.68641,1535,32,784,240,751,77.69111,73.68421,92,1234,75.0,86.07595,237,79.82172,204,10,200,84,198,641,985,6.993007,114,143,20.253164,"801011010",57.608696,264
426,992,834,413,224,83.66936,83.77282,106,"Giralang",830,67.60564,2504,37,1288,493,1216,77.15079,62.34568,188,2073,78.2967,91.36364,440,80.27014,402,32,288,101,285,1081,1664,15.458938,162,207,16.517857,"801011011",56.38298,364
0,3,0,0,0,100.0,0.0,0,"Gooromon",3,0.0,3,0,0,0,3,0.0,0.0,0,3,100.0,0.0,0,100.0,0,0,0,0,3,0,3,0.0,0,0,0.0,"801011012",0.0,3
415,1100,902,456,221,82.90909,83.82353,116,"Latham",912,72.53012,2719,31,1398,544,1321,79.401405,62.146893,203,2236,81.26649,88.22394,518,81.127014,457,35,301,110,308,1136,1814,13.358779,177,262,14.027149,"801011017",57.142857,379
389,2031,1644,1122,65,89.414085,78.40671,172,"Bonner",1816,74.03599,4350,18,2254,1431,2096,75.48209,60.893856,295,4209,87.29412,95.728455,1311,82.204796,1255,16,288,218,371,2178,3460,21.052631,358,76,27.692308,"801041035",58.305084,425
8,48,25,17,0,54.166668,85.0,0,"Lawson",26,100.0,92,0,44,20,48,67.567566,0.0,15,85,58.82353,100.0,16,60.0,16,0,8,0,10,37,51,0.0,9,7,0.0,"801011018",0.0,17
591,2164,1799,1104,249,87.75416,83.06998,247,"Macgregor (ACT)",1899,71.91201,4978,50,2565,1329,2413,78.93813,67.40947,370,4443,80.35714,93.35494,1234,83.23205,1152,28,425,242,450,2279,3698,9.79021,359,286,20.08032,"801011019",66.75676,560
430,841,679,242,178,83.234245,78.82736,124,"McKellar",700,69.76744,2128,39,1109,307,1019,74.53348,64.94253,187,1752,77.00831,88.395905,293,78.710045,259,24,300,113,278,911,1379,12.121212,174,198,21.910112,"801011021",66.31016,361
389,1339,1120,690,77,88.57356,84.45532,108,"Forde",1186,77.37789,2910,13,1494,817,1416,78.65169,56.42202,196,2763,88.83249,95.46062,749,83.46001,715,6,301,123,350,1424,2306,8.571428,218,70,16.883118,"801041038",55.10204,394
374,905,709,343,246,82.98343,81.86157,106,"Melba",751,68.716576,2369,43,1218,419,1151,75.18558,56.0,172,1848,74.58101,89.333336,375,79.004326,335,25,257,84,267,943,1460,9.090909,150,275,17.479675,"801011022",61.627907,358
259,799,640,354,259,78.848564,80.821915,85,"Page",630,65.25097,2376,13,1318,438,1058,74.50524,62.962963,154,1658,74.78992,86.97789,407,76.59831,354,15,169,102,178,859,1270,3.267974,162,459,5.019305,"801011023",55.194805,238
336,721,625,286,177,85.43689,77.297295,83,"Spence",616,65.17857,1938,35,1040,370,898,72.92882,67.54967,141,1578,77.731094,91.52047,342,78.64385,313,18,219,102,185,857,1241,9.836065,151,183,19.774012,"801011025",58.86525,238
101,329,138,44,67,62.00608,78.57143,25,"Canberra East",204,68.31683,642,15,246,56,396,74.5946,53.57143,46,514,58.988766,56.190475,105,66.536964,59,10,69,15,105,185,342,16.393442,28,61,22.38806,"801031113",54.347828,178
403,2320,1720,1162,76,82.67242,79.86254,219,"Franklin",1918,71.21588,4800,20,2404,1455,2396,74.1699,57.70065,443,4639,90.196075,89.244385,1469,78.42207,1311,5,287,266,368,2319,3638,5.882353,461,85,26.31579,"801041039",49.435665,408
550,2152,1566,869,121,81.22677,76.56387,293,"Gungahlin",1748,69.454544,4607,38,2334,1135,2273,71.86783,59.31174,499,4331,84.27788,86.437614,1106,76.51813,956,22,382,293,461,2179,3314,14.193548,494,155,31.404959,"801041040",58.717434,547
42,64,64,23,27,98.4375,71.875,9,"Hall",63,66.666664,205,5,114,32,91,73.56322,76.92308,12,151,91.89189,100.0,15,84.10596,15,3,28,10,34,87,127,11.111111,13,27,18.518518,"801041043",75.0,37
546,2641,2026,1279,92,84.43771,80.74495,263,"Harrison",2230,75.82417,5525,19,2792,1584,2733,75.372025,57.706093,476,5329,86.03839,91.39447,1592,79.86489,1455,11,414,322,493,2688,4256,10.576923,558,104,20.652174,"801041044",55.2521,573
0,0,0,0,0,0.0,0.0,0,"Mitchell",0,0.0,0,0,0,0,0,0.0,0.0,0,0,0.0,0.0,0,0.0,0,0,0,0,0,0,0,0.0,0,0,0.0,"801041045",0.0,0
1043,3351,2839,1553,315,85.88481,81.60799,401,"Ngunnawal",2878,75.35954,7675,58,4009,1903,3666,78.883026,69.06585,649,6950,83.645836,92.76694,1742,82.258995,1616,49,786,451,803,3599,5717,11.95122,653,410,18.412699,"801041046",61.787365,960
0,0,0,0,0,0.0,0.0,0,"Throsby",0,0.0,0,0,0,0,0,0.0,0.0,0,0,0.0,0.0,0,0.0,0,0,0,0,0,0,0,0.0,0,0,0.0,"801041122",0.0,0
12,933,400,44,5,31.939978,23.280424,220,"Acton",298,33.333332,1951,0,1013,189,938,39.48667,43.349754,672,1946,53.846153,28.629032,248,35.868446,71,0,4,352,7,1013,698,0.0,812,0,0.0,"801051049",32.738094,13
1087,2202,1781,576,395,84.28701,83.23699,316,"Nicholls",1856,75.62097,5265,84,2668,692,2597,78.49273,68.77551,529,4471,84.56376,91.111115,630,81.34646,574,46,822,337,882,2269,3637,11.528822,490,399,21.265823,"801041047",59.73535,1043
702,1832,1435,645,227,82.69651,78.85085,231,"Palmerston",1515,73.07692,4246,44,2187,818,2059,75.48659,60.892387,379,3733,81.333336,88.81748,778,79.02491,691,45,513,232,549,1901,2950,15.734265,381,286,19.38326,"801041048",60.949867,675
699,1440,1294,560,347,80.486115,82.23201,157,"Ainslie",1159,72.103004,3967,40,2180,681,1787,75.364006,59.94065,290,3157,77.504105,90.57301,541,77.70035,490,28,504,202,472,1717,2453,6.0475163,337,463,11.527377,"801051050",54.13793,609
0,0,0,0,0,0.0,0.0,0,"Gungahlin - East",0,0.0,0,0,0,0,0,0.0,0.0,0,0,0.0,0.0,0,0.0,0,0,0,0,0,0,0,0.0,0,0,0.0,"801041116",0.0,0
0,0,0,0,0,0.0,0.0,0,"Gungahlin - West",0,0.0,0,0,0,0,0,0.0,0.0,0,0,0.0,0.0,0,0.0,0,0,0,0,0,0,0,0.0,0,0,0.0,"801041117",0.0,0
28,195,171,121,3,90.76923,70.76023,19,"Jacka",177,85.71429,441,0,243,171,198,72.45763,70.27027,23,431,81.818184,93.333336,150,80.74246,140,0,24,26,18,236,348,0.0,37,7,0.0,"801041118",82.608696,22
0,0,0,0,0,0.0,0.0,0,"Kenny",0,0.0,0,0,0,0,0,0.0,0.0,0,0,0.0,0.0,0,0.0,0,0,0,0,0,0,0,0.0,0,0,0.0,"801041119",0.0,0
278,2293,1634,1049,120,78.28173,87.70903,297,"Braddon",1795,67.98561,4704,23,2291,1196,2413,77.148254,57.608696,557,4411,76.5,87.5,1336,77.73747,1169,25,189,371,306,2118,3429,14.450867,644,173,19.166666,"801051051",53.321365,400
0,33,18,18,3,84.84849,100.0,0,"Moncrieff",28,0.0,58,0,22,18,36,81.818184,0.0,0,55,37.5,100.0,25,83.63636,25,0,0,0,3,22,46,0.0,4,0,0.0,"801041120",0.0,8
186,1792,941,457,66,56.75223,77.589134,231,"Civic",1017,73.11828,3783,16,1925,589,1858,50.401714,31.043957,867,3659,86.79245,82.187935,713,53.511887,586,9,136,339,184,1867,1958,15.517241,1092,58,24.242424,"801051053",26.643599,212
0,0,0,0,0,0.0,0.0,0,"Taylor",0,0.0,0,0,0,0,0,0.0,0.0,0,0,0.0,0.0,0,0.0,0,0,0,0,0,0,0,0.0,0,0,0.0,"801041121",0.0,0
396,854,745,314,201,82.66979,82.414696,72,"Hackett",706,77.52525,2243,26,1188,381,1055,80.10753,64.052284,137,1784,80.70175,88.53333,375,81.33408,332,26,307,98,276,930,1451,10.077519,153,258,12.935324,"801051056",52.554745,342
534,1689,1301,716,298,80.817055,83.44988,195,"Lyneham",1365,64.41948,4146,46,2159,858,1987,73.920456,59.782608,319,3449,71.544716,87.92711,878,77.29777,772,21,344,220,352,1760,2666,5.263158,368,399,15.436241,"801051057",61.128525,492
659,1816,1460,632,274,79.84582,82.61438,249,"O'Connor (ACT)",1450,70.106224,4307,61,2217,765,2090,77.24868,69.74249,419,3706,78.616356,84.09987,761,78.52132,640,41,462,325,500,1890,2910,12.538226,466,327,22.262774,"801051058",59.427208,636
292,1528,1128,684,148,78.141365,85.28678,176,"Turner",1194,69.863014,3335,21,1659,802,1676,76.99659,59.029648,310,2993,73.31288,84.97758,892,77.581024,758,21,204,219,239,1465,2322,10.824742,371,194,14.189189,"801051060",56.774193,326
630,1923,1615,892,236,83.047325,83.91345,222,"Watson",1597,76.507935,4482,28,2323,1063,2159,80.38825,67.40506,353,3932,79.509636,89.38939,999,81.688705,893,28,482,213,454,2009,3212,8.917197,316,314,11.864407,"801051061",62.88952,571
0,0,0,0,0,0.0,0.0,0,"Black Mountain",0,0.0,0,0,0,0,0,0.0,0.0,0,0,0.0,0.0,0,0.0,0,0,0,0,0,0,0,0.0,0,0,0.0,"801051123",0.0,0
414,1022,785,307,226,79.45206,81.00264,103,"Campbell",812,74.15459,2537,49,1289,379,1248,78.343315,66.98565,187,2024,74.65116,83.703705,405,78.90316,339,31,307,140,321,1002,1597,10.801394,209,287,21.681416,"801051124",55.080215,430
175,517,464,267,95,96.13153,91.75258,31,"Barton",497,82.28571,1224,37,612,291,612,89.23077,74.07407,52,1037,87.28323,95.20548,292,92.671165,278,13,144,40,151,520,961,14.130435,54,92,38.94737,"801061129",59.615383,173
404,726,673,246,271,90.633606,83.959045,49,"Deakin",658,73.0198,2233,69,1236,293,997,74.694786,44.60784,113,1627,85.91549,91.08527,258,81.80701,235,41,295,91,305,901,1331,12.238806,204,335,25.461254,"801061062",43.36283,355
221,462,440,191,134,96.969696,87.61468,43,"Forrest",448,76.0181,1255,61,659,218,596,85.43689,61.842106,77,977,88.073395,91.01797,167,90.89048,152,34,168,47,192,515,888,23.61111,76,144,45.52239,"801061063",55.844154,218
581,1466,1211,604,288,86.56207,85.55241,137,"Griffith (ACT)",1269,75.55938,3609,76,1855,706,1754,81.05756,63.285023,230,2960,78.05695,92.33177,639,83.78378,590,37,439,131,466,1494,2480,10.249308,207,361,26.38889,"801061064",59.565216,597
0,0,0,0,0,0.0,0.0,0,"Lake Burley Griffin",0,0.0,0,0,0,0,0,0.0,0.0,0,0,0.0,0.0,0,0.0,0,0,0,0,0,0,0,0.0,0,0,0.0,"801061066",0.0,0
827,1902,1577,617,234,85.01577,84.40492,252,"Calwell",1617,75.69528,4407,40,2271,731,2136,79.52597,70.588234,408,3885,83.44031,94.405594,715,82.213646,675,34,626,300,650,1983,3194,11.805555,425,288,17.094017,"801071073",61.764706,779
811,1746,1450,672,295,77.20504,81.454544,152,"Narrabundah",1348,70.036995,4343,51,2302,825,2041,75.2465,56.70103,316,3673,73.37838,87.246376,690,76.17751,602,45,568,165,543,1927,2798,12.0,291,375,17.288136,"801061067",48.101265,740
0,0,0,0,0,0.0,0.0,0,"Parkes (ACT) - South",0,0.0,0,0,0,0,0,0.0,0.0,0,0,0.0,0.0,0,0.0,0,0,0,0,0,0,0,0.0,0,0,0.0,"801061068",0.0,0
432,990,699,249,203,75.15151,82.72425,111,"Red Hill (ACT)",744,73.37963,2364,52,1171,301,1193,77.15232,55.49133,265,1896,79.333336,81.454544,275,76.1076,224,37,317,96,357,906,1443,13.962264,173,265,25.615763,"801061069",41.88679,450
469,774,656,201,321,91.73127,76.13636,74,"Yarralumla",710,69.29637,2348,92,1253,264,1095,74.97143,52.112675,136,1649,82.42894,89.64143,251,82.83808,225,56,325,74,319,875,1366,14.814815,142,378,28.660437,"801061070",54.411766,387
477,913,787,304,180,83.57065,80.636604,103,"Gowrie (ACT)",763,72.32704,2337,40,1244,377,1093,75.239006,61.458332,171,1959,75.25773,92.655365,354,79.122,328,20,345,118,292,1046,1550,10.10101,192,198,22.222221,"801071079",60.233917,388
3,23,0,0,4,73.91304,0.0,3,"Fyshwick",17,0.0,30,4,3,0,27,0.0,0.0,3,26,100.0,33.333332,15,65.38461,5,0,0,0,5,3,17,0.0,0,0,100.0,"801061130",100.0,5
426,1654,1491,993,189,93.71221,93.15197,126,"Kingston (ACT)",1550,74.41315,3756,54,1913,1066,1843,88.53919,77.604164,177,3338,84.17431,96.34966,1041,91.102455,1003,32,317,149,367,1684,3041,13.973799,192,229,28.571428,"801061131",71.18644,436
590,1585,1399,680,143,84.85805,85.42714,212,"Banks",1345,78.13559,3647,26,1919,796,1728,79.8972,64.9315,328,3336,82.31174,92.85714,686,82.254196,637,21,461,237,470,1751,2744,12.5,365,168,18.181818,"801071071",64.63415,571
528,970,803,265,205,85.670105,88.62876,126,"Fadden",831,75.18939,2365,58,1190,299,1175,80.784706,62.874252,210,1964,79.91632,93.971634,282,83.197556,265,36,397,105,382,994,1634,18.367348,167,196,28.292683,"801071076",60.0,478
573,1273,1052,432,153,85.78162,81.355934,164,"Bonython",1092,76.61431,2999,30,1573,531,1426,77.638374,66.13546,266,2628,85.2459,92.8709,519,81.582954,482,15,439,166,416,1355,2144,6.880734,251,218,19.607843,"801071072",61.654137,488
777,1732,1356,532,209,82.505775,81.47014,245,"Chisholm",1429,74.51737,3932,36,1991,653,1941,77.17701,65.74924,376,3489,77.95858,91.32353,680,79.822296,621,30,579,215,527,1757,2785,12.820513,327,234,17.22488,"801071074",65.15958,676
752,1703,1372,517,172,82.618904,82.98556,267,"Conder",1407,76.59574,3858,20,1983,623,1875,77.60181,67.43002,416,3471,83.05556,92.06349,567,80.063385,522,14,576,265,598,1768,2779,6.5116277,393,215,11.627907,"801071075",64.18269,720
385,898,715,314,117,83.853004,79.49367,119,"Gilmore",753,70.90909,2061,31,1046,395,1015,76.14484,72.32704,189,1837,79.66102,90.42254,355,79.9129,321,13,273,115,282,939,1468,12.149532,159,107,26.495726,"801071077",62.962963,354
1112,2427,2183,843,340,84.2192,83.714005,358,"Gordon (ACT)",2044,76.97842,5904,48,3137,1007,2767,80.22786,73.58804,561,5148,83.264885,92.713005,892,82.10956,827,41,856,443,811,2721,4227,9.855769,602,416,14.117647,"801071078",63.814617,974
551,1378,1106,531,196,83.59942,83.49056,185,"Isabella Plains",1152,72.59528,3283,32,1709,636,1574,76.91238,62.151394,277,2816,76.92308,91.75084,594,80.18466,545,19,400,156,390,1438,2258,7.0110703,251,271,16.32653,"801071081",66.787,507
2048,4408,3559,1494,1089,82.41833,82.04283,460,"Kambah",3633,68.79883,11322,215,5825,1821,5497,76.07952,62.546352,839,9086,75.92901,89.97735,1766,79.15475,1589,150,1409,506,1369,4678,7192,13.077594,809,1147,19.742884,"801071082",54.827175,1803
227,642,463,226,120,86.760124,71.06918,63,"Greenway",557,69.162994,1572,15,810,318,762,72.11838,70.103096,96,1284,80.76923,91.20879,364,79.439255,332,12,157,68,147,642,1020,7.142857,97,168,12.5,"801071080",65.625,182
320,723,656,315,229,88.24343,89.23513,64,"Holder",638,73.4375,2016,45,1064,353,952,83.35451,64.91228,110,1510,80.70175,91.15854,328,85.695366,299,32,235,74,230,787,1294,11.552346,114,277,19.650656,"801081094",58.18182,285
243,468,397,146,82,89.10256,88.48485,66,"Macarthur",417,73.66255,1108,18,558,165,550,79.241516,68.81721,95,969,83.56808,96.875,160,84.00413,155,8,179,64,178,501,814,14.035088,93,57,21.95122,"801071083",69.47369,213
359,849,744,385,245,82.8033,84.24508,69,"Rivett",703,66.85237,2368,26,1274,457,1094,77.58081,58.041958,117,1808,74.085365,90.346535,404,80.03319,365,36,240,83,243,959,1447,11.428572,143,315,10.612245,"801081095",58.974358,328
261,524,443,191,225,82.25191,81.97425,61,"Stirling",431,68.582375,1607,31,858,233,749,75.986275,56.179775,105,1107,73.42342,89.3401,197,78.952126,176,23,179,50,163,583,874,8.363636,89,275,13.777778,"801081096",58.095238,222
790,1616,1334,518,376,84.46782,81.83254,221,"Monash",1365,74.05064,4217,63,2225,633,1992,77.64843,69.15254,342,3334,80.46647,89.96599,588,80.95381,529,27,585,204,552,1718,2699,5.3254437,295,507,16.75532,"801071084",64.61988,686
0,0,0,0,0,0.0,0.0,0,"Mount Taylor",0,0.0,0,0,0,0,0,0.0,0.0,0,0,0.0,0.0,0,0.0,0,0,0,0,0,0,0,0.0,0,0,0.0,"801071085",0.0,0
284,539,461,160,95,79.22078,78.81773,66,"Oxley (ACT)",427,72.88732,1329,27,695,203,634,76.45108,67.24138,129,1142,72.888885,91.89189,185,77.758316,170,16,207,78,164,603,888,17.391304,116,92,28.421053,"801071086",51.162792,225
399,988,785,363,140,80.76923,81.02679,123,"Richardson",798,74.686714,2292,23,1164,448,1128,76.73509,61.93182,204,2011,75.72559,90.12346,405,78.71706,365,15,298,109,287,1023,1583,10.638298,176,141,16.428572,"801071087",60.294117,379
554,1307,1057,441,108,83.397095,84.48276,196,"Theodore",1090,77.43682,2879,26,1464,522,1415,78.76304,65.413536,303,2649,83.81148,88.95349,516,81.04945,459,13,429,174,409,1342,2147,10.655738,266,122,24.074074,"801071088",64.68647,488
3,0,3,0,0,0.0,0.0,0,"Tuggeranong",0,100.0,3,0,3,0,0,100.0,0.0,0,3,0.0,0.0,0,100.0,0,0,3,0,0,3,3,0.0,0,0,0.0,"801071089",0.0,0
1068,2301,1844,773,534,83.224686,81.62619,262,"Wanniassa",1915,68.82022,5786,107,2951,947,2835,76.35611,67.5,438,4716,76.89031,89.17749,924,79.70738,824,66,735,270,722,2415,3759,12.313433,400,536,20.037453,"801071090",59.817352,939
313,755,619,300,205,83.97351,84.50704,60,"Waramanga",634,70.607025,1992,29,1032,355,960,79.25736,60.17699,102,1536,78.09524,88.46154,338,81.57552,299,30,221,68,246,781,1253,11.952191,113,251,14.146341,"801081097",58.82353,315
0,0,0,0,0,0.0,0.0,0,"Tuggeranong - West",0,0.0,0,0,0,0,0,0.0,0.0,0,0,0.0,0.0,0,0.0,0,0,0,0,0,0,0,0.0,0,0,0.0,"801071132",0.0,0
417,944,807,365,279,84.63983,83.14351,88,"Weston",799,77.21822,2579,46,1356,439,1223,80.61938,55.86207,159,1945,80.47494,88.66995,406,82.570694,360,39,322,81,305,1001,1606,10.985915,145,355,16.487455,"801081098",55.345913,379
384,740,643,219,282,90.0,87.6,111,"Chapman",666,76.5625,2110,60,1088,250,1022,81.3924,63.46154,172,1530,82.954544,93.98148,216,85.55556,203,31,294,99,292,790,1309,10.402684,156,298,21.276596,"801081091",64.53488,352
409,865,786,367,227,84.9711,89.51219,93,"Duffy",735,72.371635,2319,40,1227,410,1092,80.04073,60.1227,165,1847,80.57743,92.47649,319,82.349754,295,25,296,98,307,982,1521,10.204082,163,245,17.621145,"801081092",56.363636,381
338,811,728,351,237,86.683105,84.98789,82,"Fisher",703,76.62722,2238,30,1190,413,1048,83.2952,70.731705,125,1685,80.5921,90.57591,382,84.92582,346,31,259,87,245,874,1431,9.810126,123,316,12.658228,"801081093",65.6,304
705,1486,1294,533,405,83.44549,86.94943,161,"Curtin",1240,77.30496,4003,56,2112,613,1891,81.0777,64.38849,283,3082,78.99543,92.30769,546,82.21934,504,37,545,179,519,1596,2534,7.1705427,278,516,13.827161,"801091100",56.89046,657
434,935,794,298,278,88.12834,83.943665,138,"Farrer",824,76.72811,2551,51,1338,355,1213,81.77137,67.03297,223,1906,86.131386,93.355484,301,84.889824,281,41,333,122,354,971,1618,11.171662,182,367,18.345324,"801091101",61.883408,411
414,882,758,332,296,85.487526,79.80769,75,"Garran",754,74.87923,2517,51,1339,416,1178,78.549225,67.40741,144,1847,83.02872,87.323944,355,81.86248,310,25,310,91,318,965,1512,6.684492,135,374,17.22973,"801091102",52.083332,383
349,641,543,181,263,86.73947,84.18604,81,"Isaacs",556,69.05444,1935,52,1031,215,904,77.57143,66.911766,136,1341,80.26316,89.054726,201,81.953766,179,30,241,91,244,700,1099,9.063444,136,331,19.771864,"801091104",59.558823,304
280,959,669,351,232,78.623566,76.97369,104,"Lyons (ACT)",754,68.92857,2388,27,1197,456,1191,74.66518,63.75,186,1855,75.625,84.10596,453,76.71159,381,23,193,102,242,896,1423,7.6411963,160,301,11.637931,"801091105",55.91398,320
391,1002,787,357,231,84.83034,78.9823,105,"Mawson",850,70.84399,2581,35,1348,452,1233,75.60039,60.60606,180,2043,79.67033,91.70306,458,80.127266,420,33,277,120,290,1041,1637,10.749186,198,307,15.151515,"801091106",58.333332,364
154,275,212,49,108,92.36364,74.242424,39,"O'Malley",254,75.32468,761,40,378,66,383,73.8676,44.77612,76,562,88.97059,85.71429,63,82.91815,54,17,116,30,121,287,466,18.681318,67,91,37.037037,"801091107",51.31579,136
343,737,613,253,217,83.17503,89.08451,87,"Pearce",613,73.17784,2001,28,1047,284,954,80.13072,64.49275,172,1502,83.333336,93.58491,265,81.624504,248,20,251,89,250,765,1226,7.0921984,138,282,12.903226,"801091108",50.581394,300
223,1020,901,626,102,86.56863,87.43017,59,"Phillip",883,70.85202,2337,16,1215,716,1122,83.11808,64.82758,87,2104,78.92377,89.014084,710,84.79088,632,23,158,94,176,1084,1784,17.557251,145,131,15.686275,"801091109",67.81609,223
0,0,0,0,0,0.0,0.0,0,"Arboretum",0,0.0,0,0,0,0,0,0.0,0.0,0,0,0.0,0.0,0,0.0,0,0,0,0,0,0,0,0.0,0,0,0.0,"801101134",0.0,0
101,549,498,348,28,90.52824,83.85542,55,"Coombs",497,74.25742,1220,5,643,415,577,82.178215,76.666664,81,1155,86.72566,95.49296,355,86.14719,339,6,75,69,98,606,995,16.216217,90,37,17.857143,"801101135",67.90124,113
0,0,0,0,0,0.0,0.0,0,"Denman Prospect",0,0.0,0,0,0,0,0,0.0,0.0,0,0,0.0,0.0,0,0.0,0,0,0,0,0,0,0,0.0,0,0,0.0,"801101136",0.0,0
0,0,0,0,0,0.0,0.0,0,"Molonglo",0,0.0,0,0,0,0,0,0.0,0.0,0,0,0.0,0.0,0,0.0,0,0,0,0,0,0,0,0.0,0,0,0.0,"801101137",0.0,0
0,4,0,0,0,0.0,0.0,0,"Molonglo - North",0,0.0,4,0,0,0,4,0.0,0.0,4,4,0.0,0.0,0,0.0,0,0,0,0,0,0,0,0.0,0,0,0.0,"801101138",0.0,0
189,948,923,612,47,94.620255,89.86784,102,"Wright",897,82.53968,2089,17,1094,681,995,88.07252,81.46067,132,1996,87.76596,97.611465,628,91.182365,613,10,156,145,165,1048,1820,21.73913,178,46,36.17021,"801101139",77.27273,188
55,197,153,77,17,89.84772,88.505745,22,"ACT - South West",177,80.0,406,11,192,87,214,86.44068,68.57143,35,374,81.08108,95.454544,88,88.23529,84,8,44,24,60,177,330,53.333332,35,15,64.70588,"801111140",62.857143,74
6,10,12,9,0,100.0,100.0,0,"Namadgi",10,50.0,29,0,19,9,10,80.0,0.0,0,25,100.0,100.0,6,88.0,6,0,3,0,4,15,22,0.0,0,4,0.0,"801111141",0.0,4
189,729,317,133,100,68.03841,71.50538,34,"Christmas Island",496,75.13228,1296,65,467,186,829,74.41315,49.019608,97,1155,76.59574,51.714287,350,70.38961,181,17,142,25,216,426,813,41.463413,51,41,65.0,"901011001",35.051548,282
75,152,94,44,36,86.8421,63.768116,17,"Cocos (Keeling) Islands",132,48.0,383,4,195,69,188,57.668713,42.105263,25,315,84.72222,90.90909,55,71.74603,50,6,36,8,61,163,226,18.75,19,32,11.111111,"901021002",68.0,72
33,131,51,26,7,68.70229,55.31915,20,"Jervis Bay",90,33.333332,250,0,112,47,138,48.57143,56.0,28,236,54.71698,82.0,50,59.74576,41,0,11,14,29,105,141,0.0,25,7,0.0,"901031003",71.42857,53
